#Ack,ack_ewma(ms),send_ewma(ms),rtt_ratio,cwnd (Bytes),Last Router Ocupation Ack Arriaval(Packets),Last Router Ocupation Packet Sent(Packets),Network Situation,AckArrival(ms),TSInsideAck(ms),RTTAck(ms)
249301,395.209,387.732,1138,12981,0.979974,0,2,51652,50514,1138
260981,364.054,351.876,1137,12981,0.975619,0,2,54292,53155,1137
262441,351.547,349.516,1068,12981,0.941167,0,2,54556,53488,1068
263901,333.104,347.452,939,12981,0.899771,0,2,54760,53821,939
265361,340.966,345.645,1002,12981,0.8548,0,2,55156,54154,1002
266821,328.345,344.065,909,12981,0.81295,0,2,55396,54487,909
268281,318.802,342.681,828,12981,0.782581,0,2,55648,54820,828
269741,311.577,341.471,756,12981,0.759758,0,2,55909,55153,756
271201,316.129,340.412,771,12981,0.748538,0,2,56257,55486,771
272661,319.738,339.486,783,12981,0.756221,0,2,56602,55819,783
274121,323.271,338.675,798,12981,0.785443,0,2,56950,56152,798
287261,334.451,326.575,1010,15999,0.922526,0,2,59759,58749,1010
309161,274.933,255.103,1184,18666,0.988296,0,2,63946,62762,1184
310621,256.589,127.376,2379,7300,0.988497,0,2,65342,62963,2379
310621,254.515,111.454,2619,8760,0.983685,0,2,65582,62963,2619
329601,282.918,363.832,1061,13140,0.980644,0,2,67906,66845,1061
331061,276.053,348.478,1048,5840,0.944314,0,2,68134,67086,1048
333981,275.047,331.918,1100,5840,0.897524,0,2,68402,67302,1100
335441,286.666,344.429,1036,5840,0.839084,0,2,68770,67734,1036
338361,276.833,351.375,844,5840,0.777948,0,2,68978,68134,844
341281,284.229,367.953,696,18952,0.709455,0,1,69314,68618,696
344201,286.2,375.959,564,18384,0.637023,0,1,69614,69050,564
345661,296.425,382.964,500,17982,0.571145,0,1,69982,69482,500
348581,285.372,362.094,492,17221,0.506002,0,1,70190,69698,492
350041,298.7,369.582,462,16543,0.446502,0,1,70582,70120,462
351501,286.863,349.759,455,15906,0.396939,0,1,70786,70331,455
352961,278.505,332.414,464,15339,0.356072,0,1,71006,70542,464
355881,269.442,317.237,459,14854,0.312813,0,1,71212,70753,459
357341,286.012,330.333,439,14425,0.282461,0,1,71614,71175,439
358801,278.51,315.416,454,15885,0.255903,0,1,71840,71386,454
361721,272.071,302.364,470,16598,0.230166,0,1,72067,71597,470
364641,278.312,311.944,413,16335,0.215145,0,1,72389,71976,413
366101,292.148,314.951,466,16003,0.204502,0,1,72778,72312,466
369021,278.63,296.582,482,17096,0.205189,0,1,72962,72480,482
371941,288.801,301.509,506,16920,0.21829,0,2,73322,72816,506
374861,296.201,300.32,562,16825,0.234754,0,2,73670,73108,562
377781,298.176,299.28,582,16825,0.26166,0,2,73982,73400,582
380701,304.404,298.37,638,16825,0.295202,0,2,74330,73692,638
383621,305.353,297.574,658,16825,0.342052,0,2,74642,73984,658
386541,312.184,296.877,726,16825,0.398046,0,2,75002,74276,726
389461,315.161,296.268,770,16825,0.46954,0,2,75338,74568,770
409901,234.43,152.487,2004,14173,0.955543,0,2,79922,77918,2004
409901,233.185,78.212,3168,7300,0.974698,0,2,81086,77918,3168
409901,234.037,68.4355,3408,8760,0.97161,0,2,81326,77918,3408
409901,215.622,26.8744,4812,15274,0.987601,0,2,82730,77918,4812
409901,223.535,13.7841,5976,5840,0.987391,0,2,83894,77918,5976
409901,224.093,12.0611,6204,5840,0.943967,0,2,84122,77918,6204
437641,308.582,830.303,546,15274,0.869721,0,2,85022,84476,546
447861,283.509,746.516,494,16734,0.799756,0,2,85130,84636,494
450781,281.07,673.201,598,18194,0.733536,0,1,85394,84796,598
453701,275.937,629.051,518,19782,0.675594,0,1,85634,85116,518
456621,286.445,590.42,558,19143,0.652395,0,2,85994,85436,558
459541,295.639,556.617,598,18669,0.642096,0,2,86354,85756,598
461001,310.684,527.04,694,18359,0.653084,0,2,86770,86076,694
462461,300.349,481.16,762,18304,0.672698,0,2,86998,86236,762
465381,285.805,441.015,786,18304,0.694861,0,2,87182,86396,786
477061,243.976,145.898,2322,8760,0.92854,0,2,90158,87836,2322
525241,242.73,288.018,1338,23360,0.995801,0,2,96370,95032,1338
525241,217.389,252.016,1378,24820,0.995076,0,2,96410,95032,1378
525241,198.45,98.9655,2698,5840,0.971816,0,2,97730,95032,2698
528161,203.644,312.845,1128,5840,0.937839,0,2,97970,96842,1128
529621,272.689,414.739,756,5840,0.896859,0,2,98726,97970,756
531081,313.603,457.397,600,27740,0.886002,0,2,99326,98726,600
534001,286.402,409.597,621,27740,0.884002,0,2,99422,98801,621
536921,258.102,367.773,606,27740,0.897251,0,2,99482,98876,606
538381,239.339,331.176,639,27740,0.906345,0,2,99590,98951,639
574881,258.47,337.928,965,11680,0.988078,0,2,103742,102777,965
574881,256.161,295.687,1205,13140,0.987069,0,2,103982,102777,1205
574881,235.181,52.1118,4277,11680,0.990221,0,2,107054,102777,4277
574881,220.71,11.9957,6725,20940,0.996499,0,2,109502,102777,6725
574881,223.121,10.4962,6965,1460,0.989437,0,2,109742,102777,6965
617221,203.359,682.398,1053,13140,0.990259,0,2,110882,109829,1053
617221,204.939,597.098,1269,13140,0.945227,0,2,111098,109829,1269
618681,226.822,583.586,1160,13140,0.893323,0,2,111478,110318,1160
621601,209.469,531.013,1085,14600,0.847908,0,2,111566,110481,1085
624521,210.285,524.136,825,17520,0.805669,0,2,111782,110957,825
627441,226,509.619,753,19480,0.753711,0,2,112118,111365,753
630361,241.25,496.917,693,19022,0.713247,0,2,112466,111773,693
631821,255.593,485.802,641,18521,0.690341,0,2,112822,112181,641
633281,252.144,450.577,665,17977,0.675298,0,2,113050,112385,665
634741,250.626,419.755,701,17547,0.667136,0,2,113290,112589,701
637661,249.798,392.785,741,17232,0.667494,0,2,113534,112793,741
639121,275.073,394.687,785,17032,0.680307,0,2,113986,113201,785
640581,269.189,370.851,809,16932,0.699019,0,2,114214,113405,809
642041,264.04,349.995,833,16889,0.725392,0,2,114442,113609,833
643501,258.035,331.746,845,16889,0.750968,0,2,114658,113813,845
656641,230.231,142.095,1977,7300,0.951111,0,2,117626,115649,1977
663941,228.206,183.075,1824,13140,0.977051,0,2,119210,117386,1824
674161,238.05,180.935,1940,5840,0.982201,0,2,120674,118734,1940
674161,253.319,81.2027,3548,8760,0.980762,0,2,122282,118734,3548
674161,251.654,71.0523,3788,10220,0.981917,0,2,122522,118734,3788
674161,242.343,31.8879,5180,14600,0.985634,0,2,123914,118734,5180
674161,249.197,16.3556,6464,17152,0.963882,0,2,125198,118734,6464
704821,264.547,774.311,756,17918,0.917146,0,2,125570,124814,756
704821,268.979,677.522,1056,17918,0.866253,0,2,125870,124814,1056
707741,271.357,649.082,894,17918,0.811722,0,2,126158,125264,894
710661,273.437,624.197,732,13689,0.759006,0,2,126446,125714,732
712121,291.257,602.422,698,13747,0.707881,0,2,126862,126164,698
713581,290.85,567.619,662,15207,0.653145,0,1,127150,126488,662
715041,293.494,535.667,662,16058,0.605252,0,1,127462,126800,662
716501,288.307,507.709,602,15796,0.560846,0,1,127714,127112,602
717961,279.269,475.37,569,15497,0.52199,0,1,127930,127361,569
719421,274.36,447.074,560,15188,0.477991,0,1,128170,127610,560
720881,273.065,422.315,575,14907,0.441992,0,1,128434,127859,575
722341,267.432,400.65,554,14683,0.410493,0,1,128662,128108,554
723801,259.503,381.694,509,14458,0.390432,0,1,128866,128357,509
725261,261.565,365.107,536,14215,0.370378,0,1,129142,128606,536
726721,264.87,350.594,575,14028,0.36033,0,1,129430,128855,575
728181,261.761,337.895,566,13915,0.359039,0,2,129670,129104,566
729641,263.541,326.783,593,13803,0.357909,0,2,129946,129353,593
731101,265.098,317.06,620,13737,0.361921,0,2,130222,129602,620
732561,264.961,308.552,635,13709,0.375431,0,2,130486,129851,635
734021,264.841,301.108,650,13709,0.387252,0,2,130750,130100,650
735481,264.736,294.595,665,13709,0.402595,0,2,131014,130349,665
736941,266.144,288.895,692,13709,0.438521,0,2,131290,130598,692
738401,270.376,283.909,743,13709,0.492456,0,2,131590,130847,743
753001,271.4,258.184,1061,14610,0.853978,0,2,134398,133337,1061
754461,265.975,257.036,1040,14610,0.85723,0,2,134626,133586,1040
755921,262.728,256.031,1031,14610,0.871327,0,2,134866,133835,1031
757381,259.887,255.152,1022,14610,0.878661,0,2,135106,134084,1022
786581,245.114,174.879,2148,5840,0.984443,0,2,141050,138902,2148
786581,244.474,153.019,2388,1460,0.961387,0,2,141290,138902,2388
795341,242.415,339.392,972,5840,0.943714,0,2,141518,140546,972
795341,276.613,296.968,1488,17520,0.902,0,2,142034,140546,1488
798261,258.537,367.972,755,17520,0.863,0,2,142166,141411,755
801181,254.719,339.975,839,18980,0.826375,0,2,142394,141555,839
804101,246.88,333.478,743,21900,0.799328,0,2,142586,141843,743
807021,253.52,327.794,755,24820,0.768162,0,2,142886,142131,755
809941,254.83,322.819,731,24332,0.760892,0,2,143150,142419,731
812861,257.476,318.467,719,23805,0.76453,0,2,143426,142707,719
815781,268.791,314.659,779,23318,0.777714,0,2,143774,142995,779
827461,271.288,257.632,1135,22973,0.896489,0,2,145426,144291,1135
828921,226.072,109.249,2327,13140,0.953102,0,2,146762,144435,2327
828921,227.813,95.5931,2567,14600,0.951464,0,2,147002,144435,2567
842061,200.823,368.378,996,13140,0.979573,0,2,148478,147482,996
842061,212.395,144.66,2532,20706,0.989478,0,2,150014,147482,2532
846441,223.461,178.754,2493,20440,0.991631,0,2,152642,150149,2493
846441,225.529,156.41,2733,20706,0.990177,0,2,152882,150149,2733
884401,212.092,246.562,1636,5840,0.983666,0,2,154910,153274,1636
884401,212.58,215.742,1852,5840,0.964458,0,2,155126,153274,1852
884401,277.508,188.774,2584,5840,0.93015,0,2,155858,153274,2584
884401,263.819,165.178,2752,1460,0.907632,0,2,156026,153274,2752
884401,290.842,144.53,3232,5840,0.885428,0,2,156506,153274,3232
900461,260.487,457.339,633,7300,0.868499,0,2,156554,155921,633
900461,254.926,400.172,849,8760,0.861187,0,2,156770,155921,849
901921,278.06,403.4,863,8760,0.877288,0,2,157210,156347,863
920901,287.274,306.75,1082,18019,0.968003,0,2,160198,159116,1082
922361,252.886,132.409,2445,7300,0.977435,0,2,161774,159329,2445
961781,263.39,328.977,1074,5840,0.981887,0,2,168358,167284,1074
963241,258.966,314.48,1089,5840,0.931651,0,2,168586,167497,1089
964701,255.095,301.795,1104,5840,0.876445,0,2,168814,167710,1104
966161,253.208,293.071,1112,5840,0.820639,0,2,169054,167942,1112
969081,243.057,308.437,868,16060,0.786809,0,2,169226,168358,868
970541,255.675,328.882,740,17927,0.767208,0,2,169570,168830,740
972001,252.216,317.272,732,17444,0.767557,0,2,169798,169066,732
973461,253.689,307.113,760,17011,0.780362,0,2,170062,169302,760
990981,283.966,274.956,1120,16380,0.946941,0,2,173254,172134,1120
1001201,231.911,118.85,2304,8760,0.988063,0,2,175994,173690,2304
1011421,245.414,161.05,2172,13140,0.990893,0,2,177542,175370,2172
1034781,250.817,343.084,1037,5840,0.962675,0,2,181438,180401,1037
1036241,249.465,327.949,1055,5840,0.91609,0,2,181678,180623,1055
1039161,242.782,314.705,1029,5840,0.872829,0,2,181874,180845,1029
1042081,263.434,349.492,844,16060,0.812475,0,2,182282,181438,844
1045001,269.505,363.555,694,18699,0.762166,0,2,182594,181900,694
1046461,289.317,373.611,678,18122,0.718145,0,2,183022,182344,678
1047921,280.152,354.66,672,17597,0.682127,0,2,183238,182566,672
1049381,273.633,338.077,678,17125,0.655611,0,2,183466,182788,678
1050841,267.929,323.568,684,16719,0.63491,0,2,183694,183010,684
1052301,262.938,310.872,690,16378,0.619296,0,2,183922,183232,690
1053761,260.071,299.763,708,16089,0.605634,0,2,184162,183454,708
1055221,257.562,290.042,726,15866,0.60118,0,2,184402,183676,726
1056681,253.867,281.537,732,15696,0.594782,0,2,184630,183898,732
1058141,250.633,274.095,738,15552,0.589185,0,2,184858,184120,738
1059601,244.804,267.583,720,17012,0.594287,0,2,185062,184342,720
1061061,244.204,261.885,738,18236,0.603751,0,2,185302,184564,738
1062521,246.678,256.9,780,16466,0.622032,0,2,185566,184786,780
1063981,245.843,252.537,798,16466,0.640528,0,2,185806,185008,798
1066901,239.613,243.22,816,16466,0.664212,0,2,186002,185186,816
1068361,266.161,261.442,879,17588,0.694935,0,2,186454,185575,879
1080041,227.251,97.0259,2378,8760,0.949206,0,2,189518,187140,2378
1080041,241.606,19.5427,5366,17520,0.988519,0,2,192506,187140,5366
1106321,213.002,231.807,2881,23108,0.991462,0,2,196142,193261,2881
1106321,216.377,202.831,3121,24568,0.980029,0,2,196382,193261,3121
1109241,240.33,507.228,891,26028,0.953776,0,2,196790,195899,891
1126761,219.289,457.824,851,27488,0.923304,0,2,196862,196011,851
1131141,205.378,414.596,847,28948,0.896641,0,2,196970,196123,847
1134061,188.705,376.772,807,30408,0.873311,0,2,197042,196235,807
1135521,175.617,343.675,779,30528,0.840397,0,2,197126,196347,779
1138441,161.165,314.716,727,30528,0.821597,0,2,197186,196459,727
1141361,162.019,289.376,783,30528,0.790148,0,2,197354,196571,783
1144281,165.767,281.204,751,29955,0.767629,0,2,197546,196795,751
1147201,167.546,274.054,707,29355,0.747926,0,2,197726,197019,707
1150121,172.103,267.797,687,28677,0.730685,0,2,197930,197243,687
1153041,180.59,262.322,703,28026,0.718099,0,2,198170,197467,703
1155961,183.516,257.532,683,27504,0.709587,0,2,198374,197691,683
1158881,187.577,253.341,675,26983,0.709638,0,2,198590,197915,675
1161801,195.63,249.673,703,26513,0.724684,0,2,198842,198139,703
1164721,205.676,246.464,755,26201,0.750348,0,2,199118,198363,755
1177861,205.977,80.9274,2551,13140,0.948501,0,2,202034,199483,2551
1199761,202.428,122.638,2508,26280,0.99267,0,2,205250,202742,2508
1199761,196.29,42.1394,4032,14600,0.994981,0,2,206774,202742,4032
1217281,224.119,622.333,1350,5840,0.976616,0,2,209714,208364,1350
1217281,226.104,544.541,1590,5840,0.957039,0,2,209954,208364,1590
1231881,373.341,803.974,374,26280,0.876159,0,2,211358,210984,374
1240641,340.174,716.602,377,27740,0.815389,0,2,211466,211089,377
1245021,317.152,640.152,428,29200,0.764715,0,2,211622,211194,428
1250861,289.508,573.258,419,29597,0.717876,0,2,211718,211299,419
1253781,284.819,514.726,566,29597,0.686891,0,2,211970,211404,566
1256701,276.217,476.635,572,28574,0.66978,0,2,212186,211614,572
1259621,277.69,443.305,650,27689,0.669807,0,2,212474,211824,650
1262541,271.479,414.142,668,27191,0.679832,0,2,212702,212034,668
1265461,264.544,388.624,674,26804,0.703603,0,2,212918,212244,674
1284441,193.768,277.092,1104,1460,0.957505,0,2,216134,215030,1104
1288821,198.939,86.1165,2701,1460,0.993016,0,2,219158,216457,2701
1319481,187.886,250.497,1503,13140,0.98885,0,2,220598,219095,1503
1341381,225.145,270.406,1308,5840,0.984285,0,2,223646,222338,1308
1341381,227.002,236.605,1548,5840,0.948749,0,2,223886,222338,1548
1341381,227.127,207.029,1776,5840,0.906406,0,2,224114,222338,1776
1345761,357.736,506.276,447,1460,0.836855,0,2,225386,224939,447
1347221,368.519,498.866,444,21900,0.775998,0,2,225830,225386,444
1348681,338.954,453.258,442,14980,0.735248,0,2,225962,225520,442
1353061,317.585,413.351,476,14980,0.697092,0,2,226130,225654,476
1355981,316.887,378.432,654,14980,0.673706,0,2,226442,225788,654
1357441,329.276,378.503,691,14695,0.678243,0,2,226858,226167,691
1358901,321.116,361.815,710,14504,0.702212,0,2,227122,226412,710
1373501,284.09,275.731,1092,17282,0.916659,0,2,229954,228862,1092
1374961,277.079,271.89,1075,17282,0.915827,0,2,230182,229107,1075
1420221,224.993,277.452,1386,5840,0.978827,0,2,237758,236372,1386
1420221,226.869,242.771,1626,5840,0.947723,0,2,237998,236372,1626
1420221,228.511,212.424,1866,17693,0.918008,0,2,238238,236372,1866
1420221,220.947,185.871,2034,19153,0.872007,0,2,238406,236372,2034
1420221,230.828,162.637,2334,1460,0.829256,0,2,238706,236372,2334
1420221,216.975,142.308,2454,5840,0.794349,0,2,238826,236372,2454
1420221,203.353,124.519,2562,7300,0.758805,0,2,238934,236372,2562
1430441,182.434,363.204,564,8760,0.725205,0,2,238970,238406,564
1430441,182.13,317.804,744,10220,0.693304,0,2,239150,238406,744
1430441,181.863,278.078,924,10220,0.660391,0,2,239330,238406,924
1430441,177.131,243.319,1068,10220,0.644092,0,2,239474,238406,1068
1433361,184.989,298.904,620,10220,0.639831,0,2,239714,239094,620
1436281,185.866,287.166,607,13140,0.653602,0,2,239906,239299,607
1439201,188.132,274.02,629,16060,0.678152,0,2,240110,239481,629
1453801,209.774,83.2214,2508,16060,0.934527,0,2,242990,240482,2508
1475701,180.048,323.053,1307,13140,0.996426,0,2,247382,246075,1307
1475701,323.243,189.368,3221,1460,0.996655,0,2,249296,246075,3221
1496141,283.739,471.254,905,10220,0.996789,0,2,250201,249296,905
1496141,242.398,241.71,1930,5840,0.995853,0,2,251226,249296,1930
1496141,242.098,211.497,2170,5840,0.968871,0,2,251466,249296,2170
1496141,238.836,185.059,2386,5840,0.942763,0,2,251682,249296,2386
1496141,232.981,161.927,2578,1460,0.923667,0,2,251874,249296,2578
1499061,289.359,460.436,712,5840,0.911959,0,2,252558,251846,712
1514461,265.189,415.757,705,19780,0.899214,0,2,252654,251949,705
1526141,244.04,376.662,698,21240,0.895562,0,2,252750,252052,698
1550961,225.471,263.606,1404,11680,0.992425,0,2,257670,256266,1404
1586001,239.733,620.519,1143,11680,0.985899,0,2,262950,261807,1143
1586001,239.766,542.954,1383,13140,0.977661,0,2,263190,261807,1383
1590381,315.566,572.925,837,21900,0.988725,0,2,265278,264441,837
1594761,289.62,520.81,789,23115,0.986384,0,2,265386,264597,789
1596221,272.918,475.208,789,23115,0.986836,0,2,265542,264753,789
1604981,259.803,435.307,801,23115,0.987231,0,2,265710,264909,801
1653161,201.432,228.926,1500,16060,0.996159,0,2,273450,271950,1500
1653161,195.293,78.661,2988,7300,0.99493,0,2,274938,271950,2988
1653161,223.147,35.3027,4428,5840,0.995225,0,2,276378,271950,4428
1653161,223.004,30.8898,4650,5840,0.984572,0,2,276600,271950,4650
1692581,274.903,419.799,951,33580,0.983076,0,2,278892,277941,951
1695501,269.04,391.324,987,35981,0.978941,0,2,279120,278133,987
1698421,262.41,366.409,1011,35951,0.977824,0,2,279336,278325,1011
1713021,218.575,281.456,903,35251,0.987376,0,2,280188,279285,903
1715941,219.753,270.274,939,35008,0.977704,0,2,280416,279477,939
1718861,234.284,260.49,1083,34917,0.976741,0,2,280752,279669,1083
1718861,221.498,227.928,1215,34917,0.978398,0,2,280884,279669,1215
1718861,195.311,199.437,1227,34917,0.979848,0,2,280896,279669,1227
1740761,189.404,35.0766,3964,17520,0.998035,0,2,285216,281252,3964
1783601,600.573,1196.81,756,5840,0.988631,0,2,292804,292048,756
1786521,654.126,1153.21,937,7300,0.977552,0,2,293833,292896,937
1789441,599.736,1037.56,928,10220,0.967858,0,2,294052,293124,928
1790901,561.769,936.364,996,13140,0.969376,0,2,294348,293352,996
1844921,224.473,159.276,2246,8760,0.982281,0,2,302479,300233,2246
1844921,226.414,139.367,2486,8760,0.970746,0,2,302719,300233,2486
1859521,230.276,184.616,2198,17520,0.989108,0,2,305599,303401,2198
1877041,266.961,398.754,934,20289,0.991913,0,2,307087,306153,934
1878501,287.091,373.41,1166,20289,0.984174,0,2,307515,306349,1166
1878501,254.704,326.733,1194,20289,0.982402,0,2,307543,306349,1194
1904781,229.325,243.199,1416,10220,0.994858,0,2,311923,310507,1416
1904781,226.159,212.799,1620,10220,0.991751,0,2,312127,310507,1620
1951501,267.5,276.268,1160,13140,0.984869,0,2,320103,318943,1160
1952961,264.062,269.234,1180,14600,0.97801,0,2,320343,319163,1180
1952961,233.055,235.58,1196,16060,0.970759,0,2,320359,319163,1196
1979241,218.409,122.475,2219,8760,0.997564,0,2,326227,324008,2219
1979241,221.107,107.166,2459,10220,0.985368,0,2,326467,324008,2459
1979241,222.594,93.7702,2692,1460,0.977197,0,2,326700,324008,2692
1996761,208.425,250.445,1509,11680,0.989795,0,2,328068,326559,1509
2006981,262.046,306.878,1145,20440,0.993516,0,2,329684,328539,1145
2008441,224.766,114.576,2523,1460,0.995272,0,2,331248,328725,2523
2031801,231.19,280.157,1228,17520,0.995298,0,2,333908,332680,1228
2031801,207.291,245.138,1268,18980,0.988385,0,2,333948,332680,1268
2053701,239.852,348.294,1317,11680,0.982184,0,2,339984,338667,1317
2087281,203.549,134.765,2185,14600,0.997671,0,2,344256,342071,2185
2087281,208.106,117.919,2425,16060,0.986712,0,2,344496,342071,2425
2101881,187.292,313.752,996,14600,0.994184,0,2,345852,344856,996
2152981,210.916,288.737,1299,14600,0.991218,0,2,354360,353061,1299
2152981,204.538,113.386,2679,1460,0.990301,0,2,355740,353061,2679
2179261,175.237,273.003,1044,17520,0.989584,0,2,357156,356112,1044
2179261,181.832,238.878,1272,18980,0.982136,0,2,357384,356112,1272
2179261,136.942,71.8204,2332,32120,0.989629,0,2,358444,356112,2332
2179261,139.721,54.9875,2620,1460,0.97581,0,2,358732,356112,2620
2179261,144.756,48.114,2800,5840,0.963834,0,2,358912,356112,2800
2179261,138.912,42.0998,2898,7300,0.958354,0,2,359010,356112,2898
2183641,169.548,349.712,779,7580,0.93606,0,2,359394,358615,779
2185101,160.354,320.623,758,9040,0.906552,0,2,359490,358732,758
2186561,152.31,292.17,761,10500,0.878233,0,2,359586,358825,761
2193861,146.271,267.274,772,11960,0.843454,0,2,359690,358918,772
2213121,141.487,245.49,787,13420,0.819273,0,2,359798,359011,787
2216041,678.301,811.179,452,14880,0.780613,0,2,364234,363782,452
2218961,628.014,733.031,542,17800,0.766787,0,2,364510,363968,542
2233561,265.41,145.305,2495,17520,0.959036,0,2,367510,365015,2495
2233561,259.233,127.142,2711,18980,0.961657,0,2,367726,365015,2711
2239401,180.365,51.3826,3596,11680,0.993639,0,2,371722,368126,3596
2239401,186.319,44.9598,3824,13140,0.976934,0,2,371950,368126,3824
2239401,223.656,9.05567,6668,7300,0.982854,0,2,374794,368126,6668
2239401,224.199,7.92371,6896,8760,0.957497,0,2,375022,368126,6896
2268601,224.674,764.683,1062,10220,0.92281,0,2,375250,374188,1062
2268601,219.09,669.098,1242,11680,0.896209,0,2,375430,374188,1242
2268601,200.704,585.461,1314,5840,0.870433,0,2,375502,374188,1314
2268601,195.116,512.278,1470,5840,0.835379,0,2,375658,374188,1470
2268601,185.726,448.243,1590,5840,0.814706,0,2,375778,374188,1590
2268601,179.01,392.213,1722,5840,0.786618,0,2,375910,374188,1722
2328461,242.356,85.2448,3588,10220,0.988675,0,2,383290,379702,3588
2379561,215.745,449.252,885,17916,0.994598,0,2,389014,388129,885
2379561,215.777,393.095,1101,19376,0.979023,0,2,389230,388129,1101
2388321,241.801,341.639,1021,23669,0.986741,0,2,390562,389541,1021
2391241,249.076,338.934,1001,23669,0.984648,0,2,390862,389861,1001
2405841,205.614,101.17,2501,10220,0.991383,0,2,393994,391493,2501
2420441,206.755,47.8507,4016,13140,0.994478,0,2,398314,394298,4016
2420441,210.911,41.8694,4256,14600,0.990168,0,2,398554,394298,4256
2420441,241.876,21.4752,5648,5840,0.991207,0,2,399946,394298,5648
2420441,204.156,8.43321,6920,13140,0.984047,0,2,401218,394298,6920
2420441,208.636,7.37906,7160,13140,0.972291,0,2,401458,394298,7160
2420441,239.889,3.78479,8576,5840,0.984538,0,2,402874,394298,8576
2480301,298.731,318.341,2514,8760,0.983525,0,2,408826,406312,2514
2506581,262.711,323.098,1285,18980,0.989182,0,2,411822,410537,1285
2506581,234.872,282.711,1325,20440,0.983034,0,2,411862,410537,1325
2513881,191.009,311.717,1033,14600,0.996747,0,2,414778,413745,1033
2550381,191.568,304.662,1050,5840,0.995866,0,2,417862,416812,1050
2579581,224.51,192.277,1584,13140,0.998423,0,2,422290,420706,1584
2579581,224.946,168.243,1812,1460,0.99737,0,2,422518,420706,1812
2583961,193.537,211.859,1220,11680,0.99632,0,2,423531,422311,1220
2585421,196.345,242.627,978,11680,0.98428,0,2,423747,422769,978
2629221,280.235,388.756,972,26280,0.998464,0,2,430683,429711,972
2633601,272.206,353.286,1083,27740,0.984906,0,2,430899,429816,1083
2633601,189.617,106.218,2473,36721,0.987962,0,2,432289,429816,2473
2633601,192.915,92.941,2689,1460,0.973217,0,2,432505,429816,2689
2633601,192.801,81.3234,2881,5840,0.975314,0,2,432697,429816,2881
2678861,309.103,647.345,723,1460,0.994486,0,2,438595,437872,723
2701521,669.251,796.378,1221,11680,0.994672,0,2,444591,443370,1221
2704441,347.079,303.417,2080,10220,0.984419,0,2,445999,443919,2080
2704441,333.694,265.49,2320,10220,0.982617,0,2,446239,443919,2320
2714661,274.636,445.651,1040,10220,0.983449,0,2,447571,446531,1040
2738021,218.762,318.948,1336,11680,0.995833,0,2,450379,449043,1336
2752621,226.146,315.711,1148,13140,0.998107,0,2,453567,452419,1148
2783281,229.641,133.264,2380,7300,0.99247,0,2,460771,458391,2380
2799341,227.66,323.195,937,10220,0.99162,0,2,462127,461190,937
2799341,224.703,282.796,1141,11680,0.985168,0,2,462331,461190,1141
2806641,284.869,326.998,1091,17520,0.987564,0,2,463551,462460,1091
2808101,274.761,306.498,1132,18980,0.985368,0,2,463755,462623,1132
2809561,204.721,113.317,2245,7300,0.971222,0,2,465031,462786,2245
2809561,206.131,99.1521,2461,8760,0.96357,0,2,465247,462786,2461
2831461,197.391,83.6237,3029,13140,0.996229,0,2,469207,466178,3029
2831461,202.717,73.1707,3269,14600,0.98545,0,2,469447,466178,3269
2831461,205.877,64.0244,3497,16060,0.984769,0,2,469675,466178,3497
2831461,222.143,56.0214,3833,17520,0.985423,0,2,470011,466178,3833
2831461,180.874,11.2837,5885,17520,0.995814,0,2,472063,466178,5885
2831461,171.765,9.87321,5993,18980,0.995087,0,2,472171,466178,5993
2831461,200.155,3.87717,7594,5840,0.996821,0,2,473772,466178,7594
2831461,203.635,3.39252,7822,5840,0.989718,0,2,474000,466178,7822
2831461,203.681,2.96846,8026,5840,0.984753,0,2,474204,466178,8026
2926361,193.972,458.428,1276,14600,0.989875,0,2,483000,481724,1276
2949721,266.556,346.148,1264,14600,0.996711,0,2,486128,484864,1264
2949721,236.736,302.88,1292,16060,0.990872,0,2,486156,484864,1292
2952641,216.72,340.44,948,18980,0.991415,0,2,487584,486636,948
2968701,197.308,97.1583,2519,1460,0.981176,0,2,490452,487933,2519
2971621,201.144,294.889,1068,5840,0.953529,0,2,490680,489612,1068
2971621,201.501,258.027,1272,7300,0.935588,0,2,490884,489612,1272
2971621,192.814,225.774,1404,8760,0.91989,0,2,491016,489612,1404
2971621,183.712,197.552,1524,10220,0.903653,0,2,491136,489612,1524
2973081,175.748,281.983,771,10220,0.889447,0,2,491256,490485,771
2984761,168.779,263.735,755,11680,0.877016,0,2,491376,490621,755
2989141,161.182,247.768,727,13140,0.861139,0,2,491484,490757,727
2989141,156.034,216.797,847,14600,0.847246,0,2,491604,490757,847
2992061,169.53,223.698,839,14600,0.840091,0,2,491868,491029,839
2994981,178.339,229.735,807,17520,0.826329,0,2,492108,491301,807
2997901,189.046,235.019,799,20440,0.819288,0,2,492372,491573,799
3000821,202.916,239.641,827,23360,0.815627,0,2,492672,491845,827
3003741,219.551,247.436,861,25734,0.821174,0,2,493008,492147,861
3006661,229.607,258.007,829,25417,0.824777,0,2,493308,492479,829
3009581,239.906,258.756,877,25083,0.83043,0,2,493620,492743,877
3012501,245.918,259.411,901,24889,0.850376,0,2,493908,493007,901
3027101,224.335,43.2565,3877,11680,0.986915,0,2,498336,494459,3877
3027101,226.145,1.53551,9649,21455,0.998286,0,2,504108,494459,9649
3044621,454.417,1471.53,620,20440,0.977745,0,2,506844,506224,620
3056301,424.615,1313.08,632,19408,0.976777,0,2,507060,506428,632
3094261,295.249,359.935,2204,7300,0.977154,0,2,509856,507652,2204
3094261,288.343,314.943,2444,1460,0.97751,0,2,510096,507652,2444
3110321,244.451,346.522,1348,13140,0.986168,0,2,511632,510284,1348
3110321,220.163,136.078,2776,5840,0.987068,0,2,513060,510284,2776
3127841,226.207,137.431,2400,11680,0.986471,0,2,516048,513648,2400
3130761,226.096,164.757,2256,10220,0.990937,0,2,517632,515376,2256
3130761,226.78,84.5053,3408,8760,0.986602,0,2,518784,515376,3408
3130761,222.432,73.9421,3600,10220,0.960776,0,2,518976,515376,3600
3130761,221.628,64.6993,3816,11680,0.944429,0,2,519192,515376,3816
3130761,211.925,56.6119,3960,13140,0.932626,0,2,519336,515376,3960
3130761,200.434,49.5354,4080,13140,0.934797,0,2,519456,515376,4080
3130761,193.38,43.3435,4224,13140,0.939198,0,2,519600,515376,4224
3130761,184.207,37.9256,4344,13140,0.943048,0,2,519720,515376,4344
3181861,249.07,432.091,1100,18979,0.979116,0,2,523832,522732,1100
3183321,232.892,181.461,2394,8760,0.985549,0,2,525336,522942,2394
3200841,231.206,159.194,2082,8760,0.993703,0,2,528258,526176,2082
3241721,262.959,306.502,1040,5840,0.977276,0,2,534018,532978,1040
3243181,257.089,298.189,1016,17520,0.960117,0,2,534234,533218,1016
3254861,236.947,144.582,2038,7300,0.988319,0,2,536926,534888,2038
3284061,231.026,122.174,2642,11680,0.994526,0,2,542866,540224,2642
3305961,221.366,147.553,2284,5840,0.995511,0,2,546058,543774,2284
3317641,254.908,348.342,917,21900,0.989869,0,2,547306,546389,917
3320561,250.045,325.049,971,23360,0.986135,0,2,547522,546551,971
3323481,263.789,324.918,1007,24621,0.986618,0,2,547882,546875,1007
3373121,217.396,271.735,1220,13140,0.996125,0,2,555306,554086,1220
3373121,195.972,93.3706,2616,16060,0.991168,0,2,556702,554086,2616
3387721,194.488,130.336,2364,5840,0.989888,0,2,559462,557098,2364
3412541,233.662,307.804,1108,26280,0.989212,0,2,561073,559965,1108
3443201,196.027,299.887,1255,14600,0.996054,0,2,566329,565074,1255
3459261,194.525,174.253,1936,17520,0.992034,0,2,569485,567549,1936
3459261,216.781,78.2039,3328,10220,0.986425,0,2,570877,567549,3328
3459261,214.302,26.8715,4972,18980,0.994085,0,2,572521,567549,4972
3459261,203.765,9.2333,6544,13140,0.984218,0,2,574093,567549,6544
3459261,205.294,8.07914,6760,14600,0.97994,0,2,574309,567549,6760
3459261,202.132,7.06925,6940,14600,0.978698,0,2,574489,567549,6940
3459261,238.152,1.42387,10048,19242,0.991959,0,2,577597,567549,10048
3459261,236.883,1.24588,10276,19242,0.989214,0,2,577825,567549,10276
3459261,233.649,0.489254,11860,7300,0.994515,0,2,579409,567549,11860
3459261,254.013,0.00682012,20176,19654,0.996174,0,2,587725,567549,20176
3459261,249.262,0.0059676,20392,19654,0.986652,0,2,587941,567549,20392
3459261,246.604,0.00522165,20620,19654,0.97957,0,2,588169,567549,20620
3590081,512.024,2852,679,1460,0.983814,0,2,591044,590365,679
3604681,1638.01,2233.48,1045,14814,0.983242,0,2,628079,627034,1045
3633881,398.725,436.67,1055,16349,0.99259,0,2,634043,632988,1055
3639721,350.389,365.63,1087,17070,0.986907,0,2,635135,634048,1087
3641181,341.09,353.051,1098,17070,0.953543,0,2,635411,634313,1098
3642641,325.454,342.045,1049,17070,0.92185,0,2,635627,634578,1049
3645561,307.772,329.914,988,17070,0.895369,0,2,635811,634823,988
3648481,318.801,349.925,894,18739,0.864698,0,2,636207,635313,894
3649941,335.45,367.434,856,19354,0.832861,0,2,636659,635803,856
3651401,319.019,352.13,815,19354,0.810003,0,2,636863,636048,815
3654321,303.642,334.239,802,19225,0.800003,0,2,637059,636257,802
3655781,314.687,342.209,796,18979,0.806252,0,2,637451,636655,796
3657241,303.851,324.308,825,18756,0.826721,0,2,637679,636854,825
3679141,237.099,152.939,2148,16060,0.976758,0,2,642219,640071,2148
3715641,227.86,166.956,1648,5840,0.994175,0,2,648615,646967,1648
3715641,227.878,146.086,1876,5840,0.973653,0,2,648843,646967,1876
3715641,224.893,127.825,2080,5840,0.953196,0,2,649047,646967,2080
3715641,222.282,111.847,2284,5840,0.932797,0,2,649251,646967,2284
3725861,218.496,303.866,828,1460,0.904947,0,2,649443,648615,828
3728781,240.684,295.633,986,20449,0.875579,0,2,649839,648853,986
3728781,228.599,258.679,1130,20626,0.844882,0,2,649983,648853,1130
3728781,224.024,226.344,1322,20626,0.820521,0,2,650175,648853,1322
3728781,223.021,198.051,1538,20626,0.806706,0,2,650391,648853,1538
3730241,250.143,318.92,813,20626,0.792118,0,2,650831,650018,813
3731701,250.375,309.055,825,20262,0.794353,0,2,651083,650258,825
3734621,243.578,294.423,829,19959,0.796309,0,2,651279,650450,829
3736081,263.631,305.62,849,19704,0.81802,0,2,651683,650834,849
3766741,241.693,102.83,3018,8760,0.993713,0,2,659007,655989,3018
3766741,239.981,89.9766,3246,10220,0.986999,0,2,659235,655989,3246
3795941,249.137,510.18,1053,10220,0.996745,0,2,662679,661626,1053
3797401,272.995,502.032,1048,5840,0.958402,0,2,663119,662071,1048
3798861,279.371,476.278,1076,5840,0.914852,0,2,663443,662367,1076
3801781,264.449,444.493,1014,5840,0.879245,0,2,663603,662589,1014
3803241,277.393,455.182,852,18426,0.84809,0,2,663971,663119,852
3804701,277.219,438.784,804,18229,0.823328,0,2,664247,663443,804
3806161,268.067,411.686,786,17900,0.819162,0,2,664451,663665,786
3807621,263.058,387.975,792,17584,0.823017,0,2,664679,663887,792
3809081,258.676,367.228,798,17308,0.83389,0,2,664907,664109,798
3848501,240.345,314.11,1191,11680,0.993226,0,2,672256,671065,1191
3866021,224.099,297.303,1348,11680,0.997191,0,2,674764,673416,1348
3871861,245.094,303.507,1100,5840,0.982309,0,2,676116,675016,1100
3873321,241.457,292.569,1100,5840,0.95077,0,2,676332,675232,1100
3874781,239.775,304.998,936,5840,0.921924,0,2,676560,675624,936
3876241,238.303,295.373,936,17548,0.900434,0,2,676788,675852,936
3879161,243.515,291.451,952,19008,0.871629,0,2,677068,676116,952
3880621,259.076,310.52,876,18870,0.846426,0,2,677436,676560,876
3882081,255.191,298.705,888,18614,0.821872,0,2,677664,676776,888
3883541,248.792,288.367,876,18411,0.805388,0,2,677868,676992,876
3886461,240.693,279.321,844,18222,0.793465,0,2,678052,677208,844
3887921,262.607,298.406,828,17992,0.790532,0,2,678468,677640,828
3889381,259.781,288.105,852,17762,0.792965,0,2,678708,677856,852
3890841,254.308,279.092,852,17613,0.800095,0,2,678924,678072,852
3892301,257.02,271.205,912,17478,0.821333,0,2,679200,678288,912
3912741,243.304,141.546,2008,8760,0.975155,0,2,683188,681180,2008
3912741,241.391,123.853,2236,8760,0.973261,0,2,683416,681180,2236
3959461,216.688,390.261,931,10220,0.992074,0,2,690328,689397,931
3965301,218.102,362.104,994,11680,0.966815,0,2,690556,689562,994
3965301,219.339,316.841,1222,13140,0.944713,0,2,690784,689562,1222
3965301,214.422,277.236,1402,13140,0.927874,0,2,690964,689562,1402
3965301,199.619,242.581,1498,14600,0.91314,0,2,691060,689562,1498
3965301,189.667,212.259,1618,16060,0.907747,0,2,691180,689562,1618
3965301,176.458,185.726,1702,8760,0.898029,0,2,691264,689562,1702
3965301,170.901,162.51,1834,8760,0.889525,0,2,691396,689562,1834
3965301,169.039,142.197,1990,8760,0.884584,0,2,691552,689562,1990
3965301,168.909,124.422,2158,8760,0.872761,0,2,691720,689562,2158
3965301,171.795,108.869,2350,10220,0.864916,0,2,691912,689562,2350
3978441,153.321,297.511,756,11680,0.858052,0,2,691936,691180,756
3981361,170.156,279.447,891,5840,0.844545,0,2,692224,691333,891
3984281,189.386,285.766,885,8760,0.837727,0,2,692548,691663,885
3987201,228.713,320.17,828,11680,0.841761,0,2,693052,692224,828
3988661,244.624,316.649,892,14600,0.860291,0,2,693408,692516,892
4001801,228.897,133.091,2150,11680,0.95659,0,2,695980,693830,2150
4036841,236.352,272.249,1235,14600,0.990746,0,2,700428,699193,1235
4036841,210.308,238.218,1263,16060,0.990652,0,2,700456,699193,1263
4057281,199.658,273.005,1307,13140,0.993739,0,2,703348,702041,1307
4060201,183.93,153.225,1811,5840,0.983791,0,2,704644,702833,1811
4060201,184.939,134.072,2003,5840,0.954567,0,2,704836,702833,2003
4060201,187.321,117.313,2207,5840,0.928996,0,2,705040,702833,2207
4071881,183.406,284.024,912,5840,0.906622,0,2,705196,704284,912
4074801,206.98,293.521,924,5840,0.885794,0,2,705568,704644,924
4077721,220.108,306.331,840,8760,0.87507,0,2,705880,705040,840
4080641,258.719,334.04,841,11680,0.875686,0,2,706409,705568,841
4083561,257.879,326.285,821,14600,0.878725,0,2,706661,705840,821
4086481,267.644,319.499,885,17520,0.887635,0,2,706997,706112,885
4102541,195.288,41.3425,3622,14600,0.989723,0,2,711114,707492,3622
4102541,199.262,2.19065,8098,26494,0.996956,0,2,715590,707492,8098
4155101,202.85,936.349,949,5840,0.986963,0,2,718158,717209,949
4166781,204.494,836.805,1025,5840,0.946093,0,2,718374,717349,1025
4166781,204.432,732.205,1229,5840,0.910331,0,2,718578,717349,1229
4166781,202.878,640.679,1421,5840,0.87029,0,2,718770,717349,1421
4166781,251.018,560.594,2009,5840,0.847754,0,2,719358,717349,2009
4166781,300.641,490.52,2657,1460,0.850534,0,2,720006,717349,2657
4166781,287.061,429.205,2849,5840,0.862968,0,2,720198,717349,2849
4172621,266.178,661.679,680,7300,0.878847,0,2,720318,719638,680
4185761,240.425,198.039,2348,11680,0.965862,0,2,723054,720706,2348
4185761,237.372,173.284,2564,11680,0.962629,0,2,723270,720706,2564
4200361,270.097,427.482,894,8760,0.975594,0,2,724554,723660,894
4222261,219.65,367.762,984,11680,0.993736,0,2,727518,726534,984
4228101,261.473,334.751,1128,17520,0.992578,0,2,728786,727658,1128
4229561,189.995,92.5748,2620,11680,0.991798,0,2,730398,727778,2620
4233941,187.064,280.22,1053,5840,0.968029,0,2,731730,730677,1053
4233941,193.681,245.192,1293,5840,0.937025,0,2,731970,730677,1293
4233941,196.471,214.543,1509,5840,0.898647,0,2,732186,730677,1509
4233941,207.912,187.725,1797,24820,0.855066,0,2,732474,730677,1797
4233941,222.423,164.26,2121,26280,0.829433,0,2,732798,730677,2121
4233941,206.62,143.727,2217,27740,0.812004,0,2,732894,730677,2217
4233941,192.793,125.761,2313,29200,0.804253,0,2,732990,730677,2313
4233941,188.194,110.041,2469,30660,0.812472,0,2,733146,730677,2469
4233941,178.169,96.286,2577,31267,0.822163,0,2,733254,730677,2577
4233941,175.398,84.2502,2733,1460,0.840642,0,2,733410,730677,2733
4273361,193.727,131.35,2208,10220,0.962247,0,2,736098,733890,2208
4274821,235.843,26.3108,5100,16060,0.987387,0,2,740514,735414,5100
4274821,233.363,23.022,5316,17520,0.986464,0,2,740730,735414,5316
4274821,227.643,10.3321,6684,10220,0.992675,0,2,742098,735414,6684
4274821,179.978,1.59332,9252,25607,0.98637,0,2,744666,735414,9252
4274821,185.981,1.39416,9480,5840,0.954324,0,2,744894,735414,9480
4274821,188.233,1.21989,9684,5840,0.926284,0,2,745098,735414,9684
4274821,184.204,1.0674,9840,5840,0.894248,0,2,745254,735414,9840
4274821,177.679,0.933976,9972,5840,0.866217,0,2,745386,735414,9972
4340521,315.307,602.336,1868,25856,0.952781,0,2,749478,747610,1868
4340521,210.127,3.29726,9899,25856,0.994741,0,2,757509,747610,9899
4340521,209.722,2.2089,10523,25856,0.990227,0,2,758133,747610,10523
4340521,204.506,1.93279,10691,25856,0.985199,0,2,758301,747610,10691
4340521,184.943,1.69119,10739,25856,0.975799,0,2,758349,747610,10739
4340521,179.825,1.47979,10883,25856,0.970074,0,2,758493,747610,10883
4340521,173.847,1.29482,11015,25856,0.967565,0,2,758625,747610,11015
4340521,165.616,1.13297,11123,25856,0.957869,0,2,758733,747610,11123
4340521,164.414,0.991346,11279,25856,0.949386,0,2,758889,747610,11279
4340521,155.862,0.867428,11375,25856,0.951962,0,2,758985,747610,11375
4340521,154.38,0.758999,11519,25856,0.956717,0,2,759129,747610,11519
4432501,191.062,515.885,2207,17520,0.990825,0,2,761757,759550,2207
4432501,194.18,451.399,2423,16060,0.985722,0,2,761973,759550,2423
4450021,195.326,37.8376,4422,18980,0.997383,0,2,769341,764919,4422
4450021,209.7,19.4072,5538,1460,0.996158,0,2,770457,764919,5538
4450021,213.488,16.9813,5778,5840,0.972888,0,2,770697,764919,5778
4450021,224.302,14.8587,6078,7300,0.962527,0,2,770997,764919,6078
4450021,212.764,13.0013,6210,8760,0.953461,0,2,771129,764919,6210
4492361,198.168,702.126,780,10220,0.943029,0,2,771225,770445,780
4502581,191.397,631.985,783,11680,0.9339,0,2,771369,770586,783
4502581,183.973,552.987,915,13140,0.924662,0,2,771501,770586,915
4505501,178.976,519.114,777,13140,0.92158,0,2,771645,770868,777
4506961,173.104,471.85,768,14600,0.926382,0,2,771777,771009,768
4511341,162.158,394.307,738,17520,0.942386,0,2,772029,771291,738
4530321,260.105,327.177,1072,23287,0.976125,0,2,774271,773199,1072
4531781,254.592,307.03,1122,23287,0.96911,0,2,774487,773365,1122
4533241,198.314,113.647,2256,8760,0.988136,0,2,775787,773531,2256
4533241,199.025,99.4407,2460,10220,0.980869,0,2,775991,773531,2460
4553681,194.054,299.718,1104,13140,0.991237,0,2,777335,776231,1104
4566441,761.295,687.646,1985,11680,0.994706,0,2,791609,789624,1985
4597101,216.636,113.005,2441,14600,0.988535,0,2,796145,793704,2441
4597101,203.056,98.8791,2549,1460,0.981218,0,2,796253,793704,2549
4633601,197.094,201.013,1204,27740,0.99169,0,2,798709,797505,1204
4633601,174.457,175.886,1220,29200,0.991479,0,2,798725,797505,1220
4633601,149.467,40.4875,2732,1460,0.990538,0,2,800237,797505,2732
4639441,168.109,255.323,1215,14600,0.992534,0,2,801545,800330,1215
4683241,187.213,373.292,1015,11680,0.988572,0,2,806969,805954,1015
4683241,189.069,128.266,2551,27740,0.994823,0,2,808505,805954,2551
4683241,192.436,112.233,2767,29200,0.99172,0,2,808721,805954,2767
4683241,193.881,98.204,2971,21629,0.986505,0,2,808925,805954,2971
4683241,190.646,85.9285,3139,21629,0.984442,0,2,809093,805954,3139
4744561,225.725,5.55111,7858,20440,0.99623,0,2,820133,812275,7858
4744561,229.394,2.84721,9034,5840,0.994317,0,2,821309,812275,9034
4744561,226.22,2.49131,9238,5840,0.980027,0,2,821513,812275,9238
4832161,211.292,318.61,1398,13140,0.98294,0,2,828749,827351,1398
4832161,211.881,278.784,1614,13140,0.973822,0,2,828965,827351,1614
4832161,206.149,109.477,3018,10220,0.98847,0,2,830369,827351,3018
4849681,239.435,312.753,1198,17520,0.987325,0,2,831937,830739,1198
4851141,192.475,114.141,2377,14600,0.988145,0,2,833252,830875,2377
4851141,196.916,99.8731,2605,16060,0.975877,0,2,833480,830875,2605
4868661,195.714,166.681,2234,5840,0.98753,0,2,836156,833922,2234
4868661,198.25,145.845,2450,5840,0.977839,0,2,836372,833922,2450
4899321,250.381,153.053,2432,11680,0.983594,0,2,840668,838236,2432
4899321,246.084,133.921,2648,1460,0.978145,0,2,840884,838236,2648
4922681,236.419,287.582,1186,16060,0.992179,0,2,842824,841638,1186
4922681,198.44,112.932,2319,8760,0.990679,0,2,843957,841638,2319
4934361,200.635,291.191,996,8760,0.985594,0,2,844173,843177,996
4947501,226.78,147.813,2595,1460,0.991198,0,2,848247,845652,2595
4947501,226.932,129.336,2823,5840,0.976048,0,2,848475,845652,2823
4947501,227.066,113.169,3051,7300,0.976542,0,2,848703,845652,3051
4967941,233.813,290.168,1147,5840,0.981972,0,2,850067,848920,1147
4976701,212.773,118.621,2225,11680,0.992619,0,2,852652,850427,2225
4989841,179.3,315.4,1071,13140,0.993714,0,2,854009,852938,1071
4992761,183.888,317.225,957,13140,0.98575,0,2,854225,853268,957
4992761,186.402,277.572,1161,14600,0.981281,0,2,854429,853268,1161
4992761,196.25,124.573,2385,1460,0.990349,0,2,855653,853268,2385
4992761,195.719,109.001,2577,5840,0.990305,0,2,855845,853268,2577
5026341,228.636,319.689,948,1460,0.995483,0,2,860225,859277,948
5039481,228.714,255.516,1195,11680,0.991723,0,2,861617,860422,1195
5057001,201.808,101.93,2415,13140,0.998249,0,2,865973,863558,2415
5083281,229.787,248.067,1165,18980,0.970941,0,2,868849,867684,1165
5084741,229.564,233.059,1265,20440,0.939574,0,2,869077,867812,1265
5084741,202.869,203.927,1281,21900,0.918377,0,2,869093,867812,1281
5084741,203.01,178.436,1485,23360,0.90733,0,2,869297,867812,1485
5084741,194.134,156.131,1617,24820,0.902664,0,2,869429,867812,1617
5084741,177.367,136.615,1677,16060,0.896081,0,2,869489,867812,1677
5084741,167.196,119.538,1773,14600,0.897821,0,2,869585,867812,1773
5084741,156.797,104.596,1857,13140,0.904343,0,2,869669,867812,1857
5084741,146.197,91.5213,1929,13140,0.90755,0,2,869741,867812,1929
5084741,141.422,80.0811,2037,13140,0.917856,0,2,869849,867812,2037
5084741,135.745,70.071,2133,13140,0.926874,0,2,869945,867812,2133
5124161,218.292,138.629,2632,1460,0.983261,0,2,875309,872677,2632
5124161,219.505,121.3,2860,5840,0.976603,0,2,875537,872677,2860
5157741,209.303,105.275,2388,29200,0.994738,0,2,878453,876065,2388
5172341,170.789,76.2403,3028,5840,0.998506,0,2,881573,878545,3028
5207381,166.353,269.748,852,15520,0.988163,0,2,882696,881844,852
5208841,172.559,248.779,966,16980,0.972143,0,2,882912,881946,966
5208841,177.989,217.682,1182,18440,0.966875,0,2,883128,881946,1182
5208841,176.74,190.472,1350,19900,0.964766,0,2,883296,881946,1350
5215601,390.148,471.413,796,1460,0.95792,0,2,885180,884384,796
5218521,941.379,1015.99,768,5840,0.96193,0,2,889980,889212,768
5225821,453.413,353.356,2225,16060,0.987304,0,2,892409,890184,2225
5225821,425.237,309.186,2453,17520,0.978891,0,2,892637,890184,2453
5241881,229.777,365.126,1345,13140,0.989972,0,2,897029,895684,1345
5276921,206.239,213.136,2221,18980,0.990214,0,2,900641,898420,2221
5276921,208.959,186.494,2449,20440,0.965187,0,2,900869,898420,2449
5276921,202.339,163.182,2605,21900,0.933289,0,2,901025,898420,2605
5276921,196.547,142.784,2761,5840,0.907878,0,2,901181,898420,2761
5276921,186.978,124.936,2881,23360,0.875643,0,2,901301,898420,2881
5276921,174.106,109.319,2965,24820,0.847438,0,2,901385,898420,2965
5276921,156.843,95.6543,3001,26280,0.827758,0,2,901421,898420,3001
5276921,143.237,83.6975,3049,27740,0.808038,0,2,901469,898420,3049
5276921,131.333,73.2353,3097,29200,0.788283,0,2,901517,898420,3097
5276921,126.916,64.0809,3193,30660,0.773498,0,2,901613,898420,3193
5276921,115.552,56.0708,3229,32120,0.760561,0,2,901649,898420,3229
5281301,131.108,407.562,601,33580,0.741741,0,2,901889,901288,601
5282761,131.219,369.742,628,34775,0.732773,0,2,902021,901393,628
5310501,126.817,336.649,619,34775,0.722426,0,2,902117,901498,619
5310501,125.965,294.568,739,34775,0.718373,0,2,902237,901498,739
5313421,135.719,283.997,733,34775,0.712327,0,2,902441,901708,733
5316341,145.754,274.747,739,33690,0.722036,0,2,902657,901918,739
5319261,154.535,266.654,745,32745,0.738031,0,2,902873,902128,745
5322181,160.718,259.572,739,31938,0.752027,0,2,903077,902338,739
5325101,173.628,253.376,793,31215,0.774274,0,2,903341,902548,793
5339701,211.358,97.0932,2326,14600,0.939535,0,2,906029,903703,2326
5347001,287.643,411.055,744,7300,0.963306,0,2,907625,906881,744
5354301,233.073,147.133,2268,18980,0.986142,0,2,909269,907001,2268
5354301,223.425,57.7784,3792,13140,0.993308,0,2,910793,907001,3792
5354301,243.843,11.6376,6912,11680,0.994902,0,2,913913,907001,6912
5354301,241.862,10.1829,7140,13140,0.980539,0,2,914141,907001,7140
5354301,238.63,8.91,7356,5840,0.951722,0,2,914357,907001,7356
5354301,237.301,7.79625,7584,5840,0.919007,0,2,914585,907001,7584
5354301,234.638,6.82172,7800,5840,0.882881,0,2,914801,907001,7800
5393721,674.432,1150.94,1147,23360,0.920289,0,2,920105,918958,1147
5393721,392.952,451.971,2616,1460,0.967448,0,2,921574,918958,2616
5421461,194.115,169.067,1920,16060,0.982407,0,2,924262,922342,1920
5421461,198.351,147.933,2148,16060,0.977106,0,2,924490,922342,2148
5421461,294.239,99.1039,3548,1460,0.979663,0,2,925890,922342,3548
5447741,231.882,156.907,1992,17520,0.972666,0,2,928788,926796,1992
5447741,229.897,137.293,2208,16060,0.942333,0,2,929004,926796,2208
5450661,225.16,306.132,912,17520,0.908291,0,2,929196,928284,912
5452121,222.515,303.865,828,17520,0.876005,0,2,929400,928572,828
5455041,200.7,273.382,816,17520,0.847754,0,2,929448,928632,816
5456501,190.613,258.709,780,17520,0.824285,0,2,929568,928788,780
5460881,171.286,233.871,756,17520,0.801249,0,2,929604,928848,756
5460881,166.375,204.637,888,17520,0.786093,0,2,929736,928848,888
5460881,148.579,179.057,912,17520,0.777831,0,2,929760,928848,912
5460881,140.506,156.675,996,13140,0.765602,0,2,929844,928848,996
5460881,145.443,137.091,1176,14600,0.758652,0,2,930024,928848,1176
5460881,136.263,119.954,1248,16060,0.755071,0,2,930096,928848,1248
5460881,132.105,104.96,1351,17520,0.758187,0,2,930199,928848,1351
5460881,120.092,91.84,1387,18980,0.758413,0,2,930235,928848,1387
5463801,123.08,191.36,643,20440,0.774862,0,2,930379,929736,643
5465261,115.195,174.94,643,20440,0.784254,0,2,930439,929796,643
5466721,106.796,160.573,631,20440,0.802472,0,2,930487,929856,631
5468181,105.446,148.001,667,20440,0.815913,0,2,930583,929916,667
5481321,102.766,137.001,691,20440,0.828924,0,2,930667,929976,691
5484961,104.742,126.454,733,8760,0.86402,0,2,930889,930156,733
5484961,100.443,96.8162,901,9480,0.89214,0,2,931057,930156,901
5487881,261.026,134.11,2226,5840,0.960438,0,2,934171,931945,2226
5502481,296.362,302.108,1124,8760,0.96681,0,2,935511,934387,1124
5503941,206.841,37.187,4014,13140,0.989831,0,2,938491,934477,4014
5524381,241.744,697.141,902,8760,0.989682,0,2,941671,940769,902
5527301,241.526,635.748,936,10220,0.967222,0,2,941911,940975,936
5527301,239.835,556.28,1164,11680,0.947569,0,2,942139,940975,1164
5527301,235.356,486.745,1368,13140,0.925373,0,2,942343,940975,1368
5527301,232.936,425.902,1584,14600,0.898451,0,2,942559,940975,1584
5527301,224.819,372.664,1752,16060,0.869895,0,2,942727,940975,1752
5527301,220.717,326.081,1944,17520,0.837408,0,2,942919,940975,1944
5527301,215.627,285.321,2124,18979,0.803982,0,2,943099,940975,2124
5527301,211.174,249.656,2304,18979,0.777234,0,2,943279,940975,2304
5527301,207.277,218.449,2484,18979,0.74883,0,2,943459,940975,2484
5527301,205.368,191.143,2676,1460,0.731476,0,2,943651,940975,2676
5527301,200.697,167.25,2844,5840,0.721292,0,2,943819,940975,2844
5527301,199.61,146.344,3036,7300,0.71488,0,2,944011,940975,3036
5562341,185.158,446.551,572,8760,0.70927,0,2,944095,943523,572
5562341,190.514,390.732,800,10220,0.711861,0,2,944323,943523,800
5562341,199.699,341.89,1064,10220,0.719129,0,2,944587,943523,1064
5565261,224.237,376.404,842,10220,0.742988,0,2,944983,944141,842
5576941,228.799,167.738,1864,8760,0.943233,0,2,947935,946071,1864
5576941,228.699,146.771,2092,8760,0.936579,0,2,948163,946071,2092
5584241,233.907,32.7356,4884,16060,0.991234,0,2,952591,947707,4884
5584241,217.084,12.8551,6312,11680,0.991557,0,2,954019,947707,6312
5584241,239.683,3.865,8532,18743,0.981212,0,2,956239,947707,8532
5584241,244.222,3.38187,8808,5840,0.94481,0,2,956515,947707,8808
5584241,236.195,2.95914,8988,5840,0.900459,0,2,956695,947707,8988
5584241,226.17,2.58925,9144,5840,0.851652,0,2,956851,947707,9144
5628041,469.399,1365.64,409,18980,0.793945,0,2,959023,958614,409
5636801,439.224,1221.19,427,19549,0.753452,0,2,959251,958824,427
5638261,439.321,1094.79,657,19549,0.72802,0,2,959691,959034,657
5639721,415.906,984.189,699,21009,0.710768,0,2,959943,959244,699
5641181,390.918,887.415,705,21287,0.713172,0,2,960159,959454,705
5642641,375.053,802.738,759,20842,0.732775,0,2,960423,959664,759
5654321,239.311,174.206,2353,10220,0.948791,0,2,963403,961050,2353
5666001,231.975,176.177,2052,16060,0.977391,0,2,964987,962935,2052
5682061,232.927,290.098,999,11680,0.986121,0,2,966619,965620,999
5689361,255.682,273.195,1115,16598,0.990382,0,2,968067,966952,1115
5690821,227.452,53.7372,3753,11680,0.987055,0,2,970927,967174,3753
5690821,226.021,47.02,3969,11680,0.962423,0,2,971143,967174,3969
5690821,224.768,41.1425,4185,5840,0.92462,0,2,971359,967174,4185
5690821,217.672,35.9997,4353,5840,0.887793,0,2,971527,967174,4353
5690821,217.463,31.4997,4569,5840,0.848069,0,2,971743,967174,4569
5711261,370.28,714.437,514,1460,0.81081,0,2,973183,972669,514
5712721,419.495,689.383,764,18531,0.833209,0,2,973947,973183,764
5721481,287.762,221.453,2232,7300,0.949106,0,2,976747,974515,2232
5721481,280.292,193.771,2460,7300,0.944218,0,2,976975,974515,2460
5760901,240.521,122.203,2622,5840,0.979111,0,2,984451,981829,2622
5771121,238.956,344.678,948,7300,0.961722,0,2,984679,983731,948
5771121,236.086,301.593,1164,5840,0.945257,0,2,984895,983731,1164
5771121,227.576,263.894,1332,16060,0.91835,0,2,985063,983731,1332
5771121,214.129,230.907,1452,16060,0.892306,0,2,985183,983731,1452
5774041,208.363,301.544,824,16060,0.867018,0,2,985351,984527,824
5774041,198.817,263.851,956,17520,0.837391,0,2,985483,984527,956
5776961,212.965,277.619,894,17520,0.813967,0,2,985795,984901,894
5779881,229.844,294.917,826,19442,0.790971,0,2,986143,985317,826
5781341,251.614,310.052,814,19091,0.77835,0,2,986547,985733,814
5784261,246.162,297.296,814,18768,0.769806,0,2,986755,985941,814
5785721,265.892,312.134,802,16361,0.76983,0,2,987159,986357,802
5787181,264.155,299.117,846,17821,0.782351,0,2,987411,986565,846
5788641,258.136,287.727,854,19137,0.800807,0,2,987627,986773,854
5800321,217.76,118.155,2026,7300,0.958644,0,2,990439,988413,2026
5800321,216.04,103.386,2230,8760,0.953814,0,2,990643,988413,2230
5835361,209.881,107.611,2242,7300,0.994611,0,2,996235,993993,2242
5845581,212.146,294.91,864,8760,0.992784,0,2,996463,995599,864
5845581,219.729,132.354,2244,13140,0.984262,0,2,997843,995599,2244
5845581,220.763,115.81,2472,1460,0.973729,0,2,998071,995599,2472
5845581,221.667,101.334,2700,5840,0.975763,0,2,998299,995599,2700
5845581,206.276,77.5836,3012,8760,0.977693,0,2,998611,995599,3012
5845581,195.492,67.8856,3132,10220,0.966732,0,2,998731,995599,3132
5857261,180.055,354.525,843,11680,0.95464,0,2,998803,997960,843
5857261,183.048,310.209,1047,13140,0.93156,0,2,999007,997960,1047
5864561,185.667,324.433,827,13140,0.913865,0,2,999211,998384,827
5864561,183.459,283.879,995,14600,0.895882,0,2,999379,998384,995
5867481,193.527,293.894,895,14600,0.872647,0,2,999643,998748,895
5870401,214.336,302.407,893,17520,0.859816,0,2,1000003,999110,893
5873321,219.044,303.981,830,20440,0.853589,0,2,1000255,999425,830
5876241,218.663,299.734,776,23360,0.85564,0,2,1000471,999695,776
5889381,237.162,112.017,2510,10220,0.955923,0,2,1003555,1001045,2510
5903981,191.195,54.2493,3264,10220,0.992296,0,2,1006351,1003087,3264
5903981,207.621,24.3468,4584,17520,0.995292,0,2,1007671,1003087,4584
5903981,210.168,21.3035,4812,18980,0.992131,0,2,1007899,1003087,4812
5903981,205.424,3.75453,7524,14600,0.987363,0,2,1010611,1003087,7524
5903981,210.482,1.92573,8628,5840,0.992268,0,2,1011715,1003087,8628
5903981,211.172,1.68501,8844,5840,0.969485,0,2,1011931,1003087,8844
5903981,211.775,1.47439,9060,5840,0.937049,0,2,1012147,1003087,9060
5903981,210.804,1.29009,9264,5840,0.911168,0,2,1012351,1003087,9264
5962381,318.618,412.785,2457,10220,0.974552,0,2,1017823,1015366,2457
5974061,260.087,490.928,992,11680,0.982329,0,2,1019131,1018139,992
5974061,256.076,429.562,1220,13140,0.977038,0,2,1019359,1018139,1220
5995961,229.539,356.841,1095,11680,0.979125,0,2,1021975,1020880,1095
5995961,229.347,312.236,1323,13140,0.972984,0,2,1022203,1020880,1323
6016401,211.676,299.769,1020,14600,0.979584,0,2,1025083,1024063,1020
6016401,213.717,262.298,1248,16060,0.959636,0,2,1025311,1024063,1248
6016401,211.002,229.511,1440,17520,0.938432,0,2,1025503,1024063,1440
6016401,207.127,200.822,1620,18980,0.917377,0,2,1025683,1024063,1620
6016401,190.236,175.719,1692,5840,0.888955,0,2,1025755,1024063,1692
6016401,185.956,153.754,1848,5840,0.866586,0,2,1025911,1024063,1848
6016401,177.712,134.535,1968,5840,0.842013,0,2,1026031,1024063,1968
6016401,170.498,117.718,2088,5840,0.823011,0,2,1026151,1024063,2088
6016401,164.186,103.003,2208,5840,0.806385,0,2,1026271,1024063,2208
6016401,193.162,90.128,2604,1460,0.789337,0,2,1026667,1024063,2604
6016401,187.017,78.862,2748,23360,0.77692,0,2,1026811,1024063,2748
6016401,183.14,69.0043,2904,24319,0.773555,0,2,1026967,1024063,2904
6035381,190.248,372.379,648,23323,0.77811,0,2,1027207,1026559,648
6035381,182.967,325.831,780,24585,0.789596,0,2,1027339,1026559,780
6035381,179.596,285.102,936,24585,0.804647,0,2,1027495,1026559,936
6047061,210.573,111.119,2368,13140,0.949403,0,2,1030423,1028055,2368
6047061,212.751,97.229,2596,14600,0.951977,0,2,1030651,1028055,2596
6060201,220.658,163.415,2352,20440,0.987827,0,2,1033315,1030963,2352
6080641,202.754,117.558,2587,24118,0.985857,0,2,1036387,1033800,2587
6102541,201.1,333.454,1044,13140,0.983196,0,2,1037779,1036735,1044
6102541,204.462,291.772,1272,14600,0.981547,0,2,1038007,1036735,1272
6102541,173.729,130.946,2196,5840,0.977968,0,2,1038931,1036735,2196
6102541,179.013,114.578,2412,5840,0.936972,0,2,1039147,1036735,2412
6102541,182.136,100.255,2616,1460,0.899851,0,2,1039351,1036735,2616
6109841,231.369,410.849,607,5840,0.866119,0,2,1039927,1039320,607
6122981,211.448,370.742,589,27038,0.834104,0,2,1039999,1039410,589
6125901,210.517,335.65,703,28498,0.818591,0,2,1040203,1039500,703
6128821,238.202,347.068,708,31418,0.830017,0,2,1040635,1039927,708
6143421,197.809,83.7476,2502,14600,0.958787,0,2,1043419,1040917,2502
6143421,201.583,73.2792,2730,1460,0.956439,0,2,1043647,1040917,2730
6184301,191.894,38.0056,3876,13140,0.997144,0,2,1050679,1046803,3876
6184301,213.694,19.4934,5040,5840,0.983535,0,2,1051843,1046803,5040
6184301,213.982,17.0567,5256,5840,0.949343,0,2,1052059,1046803,5256
6184301,214.234,14.9246,5472,5840,0.913175,0,2,1052275,1046803,5472
6201821,284.955,722.184,579,27863,0.875278,0,2,1053055,1052476,579
6204741,265.836,651.161,557,23248,0.844619,0,2,1053187,1052630,557
6206201,258.106,589.016,607,23248,0.822791,0,2,1053391,1052784,607
6222261,246.843,534.639,621,23248,0.818692,0,2,1053559,1052938,621
6225181,257.988,487.059,803,24708,0.830106,0,2,1053895,1053092,803
6252921,212.97,286.543,1015,11680,0.979492,0,2,1058239,1057224,1015
6252921,206.806,38.6644,4135,13140,0.988483,0,2,1061359,1057224,4135
6252921,209.455,33.8314,4363,13140,0.979922,0,2,1061587,1057224,4363
6252921,235.729,6.81422,7447,16060,0.994706,0,2,1064671,1057224,7447
6252921,233.263,5.96244,7663,5840,0.986618,0,2,1064887,1057224,7663
6252921,231.105,5.21714,7879,5840,0.975791,0,2,1065103,1057224,7879
6252921,241.217,4.56499,8191,5840,0.952567,0,2,1065415,1057224,8191
6301101,645.097,1164.18,1058,17571,0.966973,0,2,1070247,1069189,1058
6302561,592.96,1046.41,1064,17571,0.969852,0,2,1070475,1069411,1064
6337601,213.984,111.364,2410,8760,0.992132,0,2,1077843,1075433,2410
6349281,228.166,155.254,2208,5840,0.967719,0,2,1079283,1077075,2208
6349281,228.145,135.847,2436,20491,0.926754,0,2,1079511,1077075,2436
6349281,225.127,118.866,2640,20491,0.87591,0,2,1079715,1077075,2640
6356581,249.486,400.883,685,21149,0.812671,0,2,1080135,1079450,685
6359501,230.301,375.523,583,21149,0.759837,0,2,1080231,1079648,583
6362421,236.013,353.332,661,21149,0.718608,0,2,1080507,1079846,661
6363881,257.011,358.666,669,20355,0.690032,0,2,1080911,1080242,669
6365341,257.885,338.583,735,19679,0.667528,0,2,1081175,1080440,735
6368261,248.649,321.01,721,19209,0.655337,0,2,1081359,1080638,721
6369721,266.568,330.384,717,18768,0.65217,0,2,1081751,1081034,717
6371181,263.247,313.836,759,18371,0.651898,0,2,1081991,1081232,759
6372641,255.841,299.356,765,19831,0.661661,0,2,1082195,1081430,765
6374101,249.361,286.687,771,20806,0.677703,0,2,1082399,1081628,771
6375561,249.691,275.601,825,20615,0.696741,0,2,1082651,1081826,825
6378481,242.98,265.901,823,20556,0.728398,0,2,1082847,1082024,823
6381401,256.107,272.163,855,20497,0.761098,0,2,1083195,1082340,855
6400381,224.392,374.538,1060,11680,0.951569,0,2,1087251,1086191,1060
6400381,224.843,327.721,1288,13140,0.943873,0,2,1087479,1086191,1288
6400381,230.369,147.08,2704,1460,0.973561,0,2,1088895,1086191,2704
6425201,235.793,296.127,1412,11680,0.984384,0,2,1090323,1088911,1412
6428121,219.128,363.752,1008,8760,0.990884,0,2,1092015,1091007,1008
6428121,206.524,142.844,2388,16060,0.99017,0,2,1093395,1091007,2388
6428121,210.708,124.988,2628,16060,0.962649,0,2,1093635,1091007,2628
6428121,212.87,109.365,2856,17520,0.936068,0,2,1093863,1091007,2856
6428121,205.761,95.6942,3012,18980,0.910309,0,2,1094019,1091007,3012
6428121,198.041,83.7324,3156,20440,0.880271,0,2,1094163,1091007,3156
6447101,185.286,382.266,780,21900,0.858987,0,2,1094259,1093479,780
6447101,177.125,334.483,900,23262,0.832864,0,2,1094379,1093479,900
6452941,168.484,330.672,704,23262,0.810006,0,2,1094487,1093783,704
6452941,162.424,289.338,824,24722,0.787505,0,2,1094607,1093783,824
6452941,158.621,253.171,956,24722,0.770317,0,2,1094739,1093783,956
6455861,176.293,278.525,800,24722,0.747777,0,2,1095039,1094239,800
6458781,181.257,281.459,714,27642,0.748055,0,2,1095255,1094541,714
6461701,181.1,271.277,694,30562,0.768298,0,2,1095435,1094741,694
6464621,182.462,262.367,686,30864,0.791011,0,2,1095627,1094941,686
6483601,176.289,38.8416,3812,13140,0.986499,0,2,1102983,1099171,3812
6483601,215.655,15.2529,5468,21900,0.984698,0,2,1104639,1099171,5468
6483601,204.604,5.98976,6848,5840,0.988991,0,2,1106019,1099171,6848
6523021,215.625,567.752,864,27327,0.988809,0,2,1107339,1106475,864
6544921,211.172,519.283,864,27327,0.980208,0,2,1107519,1106655,864
6555141,210.275,472.373,924,27327,0.966432,0,2,1107723,1106799,924
6558061,194.491,437.326,816,27327,0.956878,0,2,1107807,1106991,816
6559521,188.179,398.535,833,19618,0.941018,0,2,1107951,1107118,833
6560981,178.157,364.593,814,19618,0.927141,0,2,1108059,1107245,814
6563901,169.387,334.894,795,21078,0.914998,0,2,1108167,1107372,795
6566821,176.714,308.907,896,21795,0.896874,0,2,1108395,1107499,896
6569741,184.625,302.044,882,23638,0.881014,0,2,1108635,1107753,882
6572661,200.547,304.164,875,26500,0.864638,0,2,1108947,1108072,875
6575581,211.478,308.143,827,26320,0.857808,0,2,1109235,1108408,827
6578501,219.543,307.125,803,26029,0.854332,0,2,1109511,1108708,803
6593101,229.12,104.025,2565,11680,0.965577,0,2,1112703,1110138,2565
6610621,219.314,10.8946,6661,11680,0.99708,0,2,1119939,1113278,6661
6610621,204.396,4.88943,7789,5840,0.97994,0,2,1121067,1113278,7789
6670481,323.02,334.497,2325,13140,0.993965,0,2,1128279,1125954,2325
6688001,256.083,409.202,1103,11680,0.996676,0,2,1130043,1128940,1103
6727421,191.302,243.62,1420,18980,0.979959,0,2,1136319,1134899,1420
6727421,192.889,213.167,1624,20440,0.958715,0,2,1136523,1134899,1624
6727421,195.778,186.521,1840,21900,0.932625,0,2,1136739,1134899,1840
6727421,192.306,163.206,2008,5840,0.907297,0,2,1136907,1134899,2008
6727421,178.767,142.805,2092,5840,0.877635,0,2,1136991,1134899,2092
6727421,163.921,124.955,2152,5840,0.854181,0,2,1137051,1134899,2152
6727421,152.431,109.335,2224,5840,0.836158,0,2,1137123,1134899,2224
6727421,148.377,95.6685,2344,5840,0.812888,0,2,1137243,1134899,2344
6727421,140.33,83.71,2428,5840,0.795027,0,2,1137327,1134899,2428
6727421,203.789,73.2462,3076,1460,0.781899,0,2,1137975,1134899,3076
6752241,185.815,378.465,621,27740,0.770411,0,2,1138035,1137414,621
6755161,249.588,401.282,756,28327,0.78286,0,2,1138731,1137975,756
6758081,254.39,379.872,814,27739,0.806253,0,2,1139019,1138205,814
6787281,216.804,384.173,1146,11680,0.980925,0,2,1143279,1142133,1146
6791661,201.959,146.675,2287,23360,0.990515,0,2,1145055,1142768,2287
6791661,220.464,6.80049,7219,14600,0.99331,0,2,1149987,1142768,7219
6791661,221.406,5.95043,7447,5840,0.967896,0,2,1150215,1142768,7447
6791661,219.23,5.20663,7651,5840,0.945659,0,2,1150419,1142768,7651
6863201,236.797,346.082,1040,16060,0.987489,0,2,1158555,1157515,1040
6863201,217.284,135.905,2492,26280,0.977587,0,2,1160007,1157515,2492
6883641,193.015,325.83,953,14600,0.992011,0,2,1161627,1160674,953
6883641,179.12,43.9655,3437,11680,0.970172,0,2,1164111,1160674,3437
6883641,185.23,38.4698,3665,13140,0.932651,0,2,1164339,1160674,3665
6883641,180.076,33.6611,3809,14600,0.892319,0,2,1164483,1160674,3809
6883641,169.567,29.4534,3905,16060,0.852029,0,2,1164579,1160674,3905
6883641,160.371,25.7718,4001,17520,0.821776,0,2,1164675,1160674,4001
6883641,159.824,22.5503,4157,18980,0.792804,0,2,1164831,1160674,4157
6883641,159.346,19.7315,4313,20440,0.772453,0,2,1164987,1160674,4313
6883641,151.428,17.2651,4409,21900,0.747147,0,2,1165083,1160674,4409
6883641,141.5,15.1069,4481,23360,0.725003,0,2,1165155,1160674,4481
6883641,138.812,13.2186,4601,24820,0.718128,0,2,1165275,1160674,4601
6883641,139.461,11.5662,4745,26280,0.719612,0,2,1165419,1160674,4745
6883641,144.528,10.1205,4925,27740,0.72341,0,2,1165599,1160674,4925
6883641,135.462,8.85541,4997,29200,0.741734,0,2,1165671,1160674,4997
6883641,129.029,7.74848,5081,30660,0.755267,0,2,1165755,1160674,5081
6883641,127.901,6.77992,5201,32120,0.774609,0,2,1165875,1160674,5201
6883641,123.913,5.93243,5297,33580,0.796533,0,2,1165971,1160674,5297
6883641,141.851,1.36559,6713,17520,0.945664,0,2,1167387,1160674,6713
6883641,218.655,0.700425,8153,21900,0.96838,0,2,1168827,1160674,8153
7000441,199.056,466.301,986,14600,0.998524,0,2,1176123,1175137,986
7000441,205.589,209.274,2246,20778,0.985588,0,2,1177383,1175137,2246
7000441,203.891,183.115,2438,20778,0.958639,0,2,1177575,1175137,2438
7000441,202.404,160.225,2630,1460,0.930059,0,2,1177767,1175137,2630
7000441,196.604,140.197,2786,5840,0.905052,0,2,1177923,1175137,2786
7000441,194.528,122.672,2966,7300,0.88817,0,2,1178103,1175137,2966
7000441,183.712,107.338,3074,8760,0.870899,0,2,1178211,1175137,3074
7016501,175.748,402.921,722,10220,0.863287,0,2,1178331,1177609,722
7023801,170.28,375.306,672,11680,0.846626,0,2,1178463,1177791,672
7023801,169.995,328.393,840,13140,0.837048,0,2,1178631,1177791,840
7023801,174.245,287.344,1044,13140,0.833667,0,2,1178835,1177791,1044
7026721,191.465,319.676,810,13140,0.843208,0,2,1179147,1178337,810
7042781,223.42,237.5,1174,30660,0.928383,0,2,1180571,1179397,1174
7042781,195.993,207.812,1178,32120,0.936085,0,2,1180575,1179397,1178
7048621,164.244,204.122,1243,14600,0.987445,0,2,1183455,1182212,1243
7099721,222.82,138.252,2484,1460,0.998616,0,2,1190235,1187751,2484
7099721,223.467,120.971,2712,5840,0.981289,0,2,1190463,1187751,2712
7099721,224.034,105.849,2940,7300,0.968628,0,2,1190691,1187751,2940
7108481,223.03,389.243,783,8760,0.956299,0,2,1190907,1190124,783
7111401,217.651,357.088,831,10220,0.938012,0,2,1191087,1190256,831
7124541,203.945,328.952,807,11680,0.92451,0,2,1191195,1190388,807
7124541,194.952,287.833,939,13140,0.907697,0,2,1191327,1190388,939
7127461,197.583,284.854,891,13140,0.895485,0,2,1191543,1190652,891
7130381,201.385,282.247,855,16060,0.889799,0,2,1191771,1190916,855
7133301,204.712,279.966,819,18980,0.884824,0,2,1191999,1191180,819
7136221,213.623,277.97,831,21900,0.879221,0,2,1192275,1191444,831
7139141,225.92,276.224,879,24820,0.878068,0,2,1192587,1191708,879
7142061,227.805,274.696,856,25240,0.88706,0,2,1192828,1191972,856
7177261,1126.16,1132.69,1211,8760,0.968514,0,2,1205878,1204667,1211
7181641,465.04,383.782,1944,13140,0.976783,0,2,1207490,1205546,1944
7190401,273.109,748.356,1017,10220,0.996914,0,2,1212307,1211290,1017
7190401,245.083,257.142,2882,5840,0.99644,0,2,1214172,1211290,2882
7241501,200.459,294.552,1088,18980,0.99143,0,2,1215704,1214616,1088
7242961,167.544,184.72,1440,5840,0.993726,0,2,1216200,1214760,1440
7242961,158.601,161.63,1536,5840,0.99326,0,2,1216296,1214760,1536
7263401,230.285,108.249,2452,10220,0.998054,0,2,1220633,1218181,2452
7263401,250.835,63.4536,3573,8760,0.997609,0,2,1221754,1218181,3573
7298441,284.544,298.435,2583,18943,0.988585,0,2,1227415,1224832,2583
7333481,266.116,332.232,1104,5840,0.99796,0,2,1232536,1231432,1104
7336401,271.826,337.57,1041,8760,0.996133,0,2,1233393,1232352,1041
7355381,246.467,363.584,919,11680,0.994221,0,2,1236233,1235314,919
7355381,251.658,318.136,1207,13140,0.991194,0,2,1236521,1235314,1207
7355381,256.201,278.369,1495,13140,0.991044,0,2,1236809,1235314,1495
7391881,266.179,124.756,2644,1460,0.998607,0,2,1245403,1242759,2644
7419621,289.746,343.08,1215,11680,0.994836,0,2,1249912,1248697,1215
7419621,247.755,153.973,2443,8760,0.996432,0,2,1251140,1248697,2443
7437141,226.173,108.819,2726,5840,0.99195,0,2,1254392,1251666,2726
7456121,230.934,114.334,2668,1460,0.996081,0,2,1257384,1254716,2668
7475101,203.816,111.26,2398,10220,0.995721,0,2,1260448,1258050,2398
7475101,208.862,38.2298,4078,13140,0.99228,0,2,1262128,1258050,4078
7515981,232.113,436.408,696,4380,0.991966,0,2,1266688,1265992,696
7517441,233.099,397.982,807,20440,0.98797,0,2,1266928,1266121,807
7546641,193.701,118.51,2795,1460,0.997308,0,2,1273812,1271017,2795
7587521,156.709,354.145,1191,17520,0.991166,0,2,1278108,1276917,1191
7587521,182.159,139.071,2595,5840,0.986531,0,2,1279512,1276917,2595
7605041,259.699,353.318,1289,32120,0.989605,0,2,1281036,1279747,1289
7605041,164.915,81.3307,2741,1460,0.995107,0,2,1282488,1279747,2741
7661981,167.337,100.248,2432,27740,0.994973,0,2,1288356,1285924,2432
7686801,162.393,284.752,1236,16060,0.985989,0,2,1289808,1288572,1236
7686801,179.594,249.158,1536,17520,0.98149,0,2,1290108,1288572,1536
7730601,184.395,295.811,1021,13680,0.992146,0,2,1292548,1291527,1021
7742821,215.935,126.692,2307,14600,0.988418,0,2,1295492,1293185,2307
7742821,218.943,110.855,2547,13140,0.983616,0,2,1295732,1293185,2547
7760341,213.814,396.251,1035,10220,0.990147,0,2,1296992,1295957,1035
7760341,214.962,346.72,1258,11680,0.975128,0,2,1297215,1295957,1258
7760341,215.092,303.38,1474,11680,0.969487,0,2,1297431,1295957,1474
7760341,213.706,265.457,1678,11680,0.967051,0,2,1297635,1295957,1678
7760341,187.891,8.24526,6334,10220,0.983977,0,2,1302291,1295957,6334
7760341,191.405,7.2146,6550,11680,0.97848,0,2,1302507,1295957,6550
7760341,203.6,2.479,8170,5840,0.988855,0,2,1304127,1295957,8170
7814361,393.753,606.285,1866,11680,0.994568,0,2,1310031,1308165,1866
7814361,370.034,530.499,2070,10220,0.983997,0,2,1310235,1308165,2070
7814361,350.78,464.187,2286,10220,0.973497,0,2,1310451,1308165,2286
7821661,314.691,563.237,816,8760,0.978459,0,2,1310847,1310031,816
7853781,261.314,273.343,1122,21420,0.991009,0,2,1315583,1314461,1122
7865461,220.109,138.429,2172,11680,0.994864,0,2,1318467,1316295,2172
7887361,228.363,195.969,1812,10220,0.982036,0,2,1322619,1320807,1812
7887361,228.318,171.473,2040,10220,0.954281,0,2,1322847,1320807,2040
7887361,228.278,150.039,2268,1460,0.952496,0,2,1323075,1320807,2268
7931161,289.162,287.864,1140,23211,0.992483,0,2,1328963,1327823,1140
7932621,224.353,106.668,2438,11680,0.991167,0,2,1330419,1327981,2438
7982261,202.462,218.213,1543,13140,0.989918,0,2,1337847,1336304,1543
7982261,204.154,190.936,1759,14600,0.984928,0,2,1338063,1336304,1759
7982261,201.135,167.069,1939,16060,0.985562,0,2,1338243,1336304,1939
8027521,186.874,229.675,1269,13140,0.987447,0,2,1345563,1344294,1269
8027521,212.661,13.9086,5697,5840,0.99174,0,2,1349991,1344294,5697
8027521,211.578,12.17,5901,7300,0.986522,0,2,1350195,1344294,5901
8027521,213.631,10.6488,6129,8760,0.984457,0,2,1350423,1344294,6129
8059641,203.427,678.318,909,10220,0.97765,0,2,1350555,1349646,909
8062561,186.999,608.153,864,11680,0.974194,0,2,1350627,1349763,864
8078621,178.624,548.134,856,13140,0.971169,0,2,1350747,1349891,856
8081541,166.796,495.617,812,14600,0.968523,0,2,1350831,1350019,812
8083001,157.946,445.665,812,16060,0.968708,0,2,1350927,1350115,812
8084461,150.203,401.957,812,17520,0.968869,0,2,1351023,1350211,812
8088841,158.428,378.212,816,18980,0.971511,0,2,1351239,1350423,816
8091761,164.124,347.436,888,20440,0.973822,0,2,1351443,1350555,888
8109281,188.641,89.9427,2484,1460,0.994713,0,2,1354191,1351707,2484
8150161,191.408,258.223,1286,14600,0.997286,0,2,1358583,1357297,1286
8150161,164.864,77.6369,2666,5840,0.992934,0,2,1359963,1357297,2666
8150161,172.756,67.9323,2894,7300,0.987567,0,2,1360191,1357297,2894
8150161,172.126,23.3421,4226,17520,0.991978,0,2,1361523,1357297,4226
8150161,205.185,10.4758,5594,5840,0.9914,0,2,1362891,1357297,5594
8150161,206.537,9.16636,5810,7300,0.981225,0,2,1363107,1357297,5810
8177901,195.482,253.15,2205,16060,0.981049,0,2,1364595,1362390,2205
8207101,175.421,270.968,1152,13140,0.990638,0,2,1366359,1365207,1152
8207101,181.772,36.5627,3684,16060,0.996237,0,2,1368891,1365207,3684
8207101,186.751,4.31686,6576,14600,0.989556,0,2,1371783,1365207,6576
8207101,208.261,0.760803,9396,19308,0.976909,0,2,1374603,1365207,9396
8207101,209.228,0.665703,9612,19308,0.972296,0,2,1374819,1365207,9612
8278641,244.364,763.67,1088,19580,0.989873,0,2,1377599,1376511,1088
8287401,248.874,475.877,1116,19580,0.994205,0,2,1379123,1378007,1116
8296161,266.954,405.205,1056,19580,0.987853,0,2,1380287,1379231,1056
8297621,262.085,380.055,1080,19580,0.969371,0,2,1380515,1379435,1080
8299081,256.324,358.048,1092,19580,0.9682,0,2,1380731,1379639,1092
8307841,247.525,302.536,1056,19580,0.97494,0,2,1381919,1380863,1056
8309301,242.084,290.219,1056,19580,0.960572,0,2,1382123,1381067,1056
8310761,238.824,279.442,1068,21040,0.959251,0,2,1382339,1381271,1068
8313681,231.971,270.011,1048,22500,0.963094,0,2,1382523,1381475,1048
8325361,234.667,140.631,2124,8760,0.989041,0,2,1385067,1382943,2124
8337041,226.504,266.975,1136,11680,0.988196,0,2,1386603,1385467,1136
8337041,204.508,91.7349,2660,21372,0.990944,0,2,1388127,1385467,2660
8354561,243.159,314.844,1121,21372,0.984105,0,2,1389508,1388387,1121
8370621,215.114,243.612,1459,11680,0.988449,0,2,1392224,1390765,1459
8372081,242.225,312.036,1100,11680,0.987393,0,2,1392656,1391556,1100
8372081,236.63,140.04,2528,1460,0.984342,0,2,1394084,1391556,2528
8388141,219.139,295.025,1314,11680,0.979223,0,2,1395296,1393982,1314
8388141,214.246,258.147,1494,11680,0.95932,0,2,1395476,1393982,1494
8388141,208.466,225.879,1662,11680,0.950655,0,2,1395644,1393982,1662
8388141,213.907,197.644,1914,13140,0.933073,0,2,1395896,1393982,1914
8388141,205.169,172.938,2058,14600,0.921439,0,2,1396040,1393982,2058
8388141,203.523,151.321,2250,1460,0.908759,0,2,1396232,1393982,2250
8388141,200.583,132.406,2430,5840,0.895164,0,2,1396412,1393982,2430
8388141,193.51,115.855,2574,7300,0.882019,0,2,1396556,1393982,2574
8388141,187.321,101.373,2718,8760,0.870516,0,2,1396700,1393982,2718
8399821,173.781,345.952,739,10220,0.857952,0,2,1396779,1396040,739
8399821,168.558,302.708,871,11680,0.851958,0,2,1396911,1396040,871
8399821,166.988,264.869,1027,11680,0.846713,0,2,1397067,1396040,1027
8399821,162.615,231.761,1159,11680,0.844624,0,2,1397199,1396040,1159
8399821,163.288,202.79,1327,11680,0.852796,0,2,1397367,1396040,1327
8412961,225.264,144.468,2089,13140,0.956274,0,2,1400079,1397990,2089
8429021,206.382,291.348,955,13140,0.978725,0,2,1401622,1400667,955
8429021,206.084,254.93,1159,14600,0.980135,0,2,1401826,1400667,1159
8429021,198.59,114.411,2354,1460,0.988585,0,2,1403021,1400667,2354
8429021,196.266,100.11,2534,5840,0.988762,0,2,1403201,1400667,2534
8449461,176.986,290.102,900,13140,0.990587,0,2,1404349,1403449,900
8452381,181.863,271.839,972,14600,0.976763,0,2,1404565,1403593,972
8453841,206.255,273.86,1061,16060,0.973418,0,2,1404942,1403881,1061
8453841,198.473,239.627,1205,18980,0.970491,0,2,1405086,1403881,1205
8453841,193.164,209.674,1361,20440,0.965429,0,2,1405242,1403881,1361
8453841,184.018,183.464,1481,8760,0.962251,0,2,1405362,1403881,1481
8453841,185.016,160.531,1673,8760,0.954469,0,2,1405554,1403881,1673
8453841,176.889,140.465,1793,8760,0.940161,0,2,1405674,1403881,1793
8453841,168.278,122.907,1901,8760,0.930141,0,2,1405782,1403881,1901
8453841,165.243,107.544,2045,10220,0.917623,0,2,1405926,1403881,2045
8466981,158.088,264.226,792,1460,0.89917,0,2,1406034,1405242,792
8469901,174.702,246.197,963,5840,0.888024,0,2,1406325,1405362,963
8472821,181.364,256.673,861,8760,0.873271,0,2,1406553,1405692,861
8472821,175.194,224.589,993,11680,0.865362,0,2,1406685,1405692,993
8472821,169.794,196.515,1125,11680,0.855942,0,2,1406817,1405692,1125
8472821,168.07,171.951,1281,11680,0.837699,0,2,1406973,1405692,1281
8472821,163.561,150.457,1413,11680,0.826737,0,2,1407105,1405692,1413
8472821,158.116,131.65,1533,11680,0.814645,0,2,1407225,1405692,1533
8475741,171.352,234.944,839,11680,0.796564,0,2,1407489,1406650,839
8478661,182.933,240.076,827,14600,0.770743,0,2,1407753,1406926,827
8481581,188.066,244.566,775,17520,0.730651,0,2,1407977,1407202,775
8484501,184.433,241.495,714,20440,0.688069,0,2,1408136,1407422,714
8487421,185.379,238.808,686,23360,0.643311,0,2,1408328,1407642,686
8490341,178.706,236.457,598,26280,0.596647,0,1,1408460,1407862,598
8493261,178.868,234.4,558,26532,0.540816,0,1,1408640,1408082,558
8496181,176.01,232.6,494,29452,0.484464,0,1,1408796,1408302,494
8499101,172.008,231.025,418,29232,0.430156,0,1,1408940,1408522,418
8500961,173.382,229.647,381,28111,0.380136,0,1,1409123,1408742,381
8503881,623.21,677.066,344,26916,0.338869,0,1,1412895,1412551,344
8506801,575.058,619.933,362,25748,0.307761,0,1,1413133,1412771,362
8509721,529.051,569.941,349,24793,0.276791,0,1,1413340,1412991,349
8512641,486.92,520.699,365,23917,0.264692,0,1,1413532,1413167,365
8515561,450.68,477.611,386,23200,0.262855,0,1,1413729,1413343,386
8518481,419.845,439.91,414,22642,0.271248,0,2,1413933,1413519,414
8521401,398.864,406.921,490,22244,0.293592,0,2,1414185,1413695,490
8524321,379.006,378.056,554,22165,0.333143,0,2,1414425,1413871,554
8527241,361.63,352.799,618,22165,0.38025,0,2,1414665,1414047,618
8530161,338.927,330.699,622,22165,0.443969,0,2,1414845,1414223,622
8546221,303.266,245.428,1162,19245,0.749206,0,2,1416441,1415279,1162
8546221,245.233,96.3787,2590,1460,0.897764,0,2,1417869,1415279,2590
8563741,230.059,274.565,1222,13140,0.944117,0,2,1419201,1417979,1222
8563741,187.559,32.4171,4186,14600,0.978402,0,2,1422165,1417979,4186
8568121,437.862,854.502,735,22031,0.962672,0,2,1425417,1424682,735
8579801,411.63,767.564,804,21863,0.928588,0,2,1425645,1424841,804
8582721,375.176,691.494,765,18943,0.881265,0,2,1425765,1425000,765
8584181,346.279,624.932,750,18943,0.829857,0,2,1425909,1425159,750
8600241,316.494,566.691,699,18943,0.774875,0,2,1426017,1425318,699
8603161,309.932,515.729,804,18943,0.709265,0,1,1426281,1425477,804
8606081,292.191,483.013,718,13067,0.649357,0,1,1426449,1425731,718
8609001,281.167,469.011,551,13560,0.584437,0,1,1426653,1426102,551
8610461,286.021,450.135,553,13891,0.527633,0,1,1426973,1426420,553
8611921,277.268,427.118,503,15351,0.482929,0,1,1427189,1426686,503
8613381,269.61,403.228,483,15451,0.451313,0,1,1427405,1426922,483
8614841,267.409,382.325,499,15084,0.433648,0,2,1427657,1427158,499
8616301,260.983,358.409,524,14794,0.430692,0,2,1427873,1427349,524
8617761,258.36,337.483,573,14580,0.440606,0,2,1428113,1427540,573
8619221,257.565,319.173,634,14489,0.48678,0,2,1428365,1427731,634
8629441,227.854,123.782,2049,7300,0.880379,0,2,1431117,1429068,2049
8629441,227.872,108.309,2277,7300,0.886581,0,2,1431345,1429068,2277
8629441,247.458,55.5527,3645,7300,0.936827,0,2,1432713,1429068,3645
8629441,241.077,24.9318,5073,14489,0.959148,0,2,1434141,1429068,5073
8629441,239.443,21.8153,5301,14489,0.960505,0,2,1434369,1429068,5301
8629441,225.891,9.79061,6573,14489,0.981025,0,2,1435641,1429068,6573
8671781,215.478,664.894,1157,13140,0.991298,0,2,1437105,1435948,1157
8680541,243.396,456.572,1241,5840,0.986787,0,2,1438493,1437252,1241
8680541,216.471,399.5,1269,5840,0.979689,0,2,1438521,1437252,1269
8680541,225.412,349.563,1557,5840,0.969727,0,2,1438809,1437252,1557
8680541,218.236,305.867,1725,5840,0.957262,0,2,1438977,1437252,1725
8683461,285.456,483.259,756,5840,0.876354,0,2,1439733,1438977,756
8683461,302.274,422.852,1176,18980,0.81556,0,2,1440153,1438977,1176
8683461,288.49,369.995,1368,14600,0.764865,0,2,1440345,1438977,1368
8683461,268.929,323.746,1500,16060,0.723007,0,2,1440477,1438977,1500
8684921,254.813,431.778,468,17520,0.691381,0,2,1440633,1440165,468
8686381,242.461,395.805,480,17520,0.676208,0,2,1440789,1440309,480
8687841,233.153,364.33,504,17520,0.670432,0,2,1440957,1440453,504
8696601,223.509,336.788,516,17520,0.670378,0,2,1441113,1440597,516
8699521,237.571,312.69,708,5840,0.687831,0,2,1441449,1440741,708
8702441,246.874,305.979,761,8760,0.723102,0,2,1441761,1441000,761
8711201,230.85,124.99,2269,10220,0.917155,0,2,1444293,1442024,2269
8711201,230.494,109.366,2497,10220,0.913761,0,2,1444521,1442024,2497
8711201,230.182,95.6956,2725,10220,0.92329,0,2,1444749,1442024,2725
8736021,246.964,134.535,2676,8760,0.979649,0,2,1448865,1446189,2676
8763761,234.008,291.779,1292,18980,0.985612,0,2,1451981,1450689,1292
8763761,208.257,255.307,1320,20440,0.97366,0,2,1452009,1450689,1320
8763761,210.725,223.394,1548,21656,0.968203,0,2,1452237,1450689,1548
8763761,218.885,195.469,1824,21656,0.928427,0,2,1452513,1450689,1824
8763761,214.024,171.036,2004,5840,0.878624,0,2,1452693,1450689,2004
8763761,206.771,149.656,2160,5840,0.827546,0,2,1452849,1450689,2160
8763761,194.425,130.949,2268,5840,0.770353,0,2,1452957,1450689,2268
8763761,180.622,114.581,2352,5840,0.715309,0,2,1453041,1450689,2352
8763761,165.544,100.258,2412,5840,0.664645,0,2,1453101,1450689,2412
8766681,149.351,315.726,624,5840,0.617814,0,1,1453137,1452513,624
8768141,165.182,331.76,456,4380,0.554338,0,1,1453413,1452957,456
8769601,162.534,314.29,408,21656,0.501295,0,1,1453557,1453149,408
8781281,154.217,295.504,340,21656,0.449883,0,1,1453653,1453313,340
8784201,167.94,279.066,440,5840,0.397398,0,1,1453917,1453477,440
8787121,185.948,285.183,424,8760,0.358973,0,1,1454229,1453805,424
8790041,204.704,290.535,432,11680,0.332852,0,1,1454565,1454133,432
8792961,228.616,295.218,500,14600,0.324995,0,1,1454961,1454461,500
8795881,248.039,299.316,556,17520,0.343121,0,2,1455345,1454789,556
8797341,267.534,302.901,632,19145,0.383981,0,2,1455749,1455117,632
8798801,259.593,285.539,672,18807,0.437233,0,2,1455953,1455281,672
8800261,257.143,270.346,748,18594,0.488829,0,2,1456193,1455445,748
8801721,252.001,257.053,800,18576,0.551475,0,2,1456409,1455609,800
8811941,219.124,90.0021,2356,7300,0.909702,0,2,1459113,1456757,2356
8823621,214.224,126.126,2148,14600,0.963973,0,2,1460805,1458657,2148
8823621,222.694,4.4772,7800,5840,0.992471,0,2,1466457,1458657,7800
8823621,236.858,3.91755,8136,5840,0.965912,0,2,1466793,1458657,8136
8854281,900.25,1640.55,583,23194,0.966423,0,2,1472337,1471754,583
8879101,547.907,818.184,1247,27197,0.981181,0,2,1473869,1472622,1247
8882021,219.368,230.478,2040,17520,0.996198,0,2,1477761,1475721,2040
8882021,222.082,90.5076,3600,8760,0.987257,0,2,1479321,1475721,3600
8882021,222.822,79.1942,3828,10220,0.98135,0,2,1479549,1475721,3828
8882021,220.469,69.2949,4032,11680,0.982431,0,2,1479753,1475721,4032
8882021,213.911,60.633,4200,13140,0.973377,0,2,1479921,1475721,4200
8882021,211.172,53.0539,4392,13140,0.955455,0,2,1480113,1475721,4392
8882021,214.775,46.4222,4632,13140,0.924773,0,2,1480353,1475721,4632
8882021,210.428,40.6194,4812,14600,0.897927,0,2,1480533,1475721,4812
8882021,203.625,35.542,4968,16060,0.864436,0,2,1480689,1475721,4968
8882021,193.172,31.0992,5088,17520,0.827631,0,2,1480809,1475721,5088
8882021,194.525,27.2118,5292,18980,0.782927,0,2,1481013,1475721,5292
8882021,191.21,23.8103,5460,20440,0.741311,0,2,1481181,1475721,5460
8882021,179.308,20.834,5556,21900,0.704897,0,2,1481277,1475721,5556
8882021,170.395,18.2298,5664,22994,0.680535,0,2,1481385,1475721,5664
8882021,165.596,15.9511,5796,22994,0.654218,0,2,1481517,1475721,5796
8882021,155.396,13.9572,5880,22994,0.638691,0,2,1481601,1475721,5880
8882021,156.972,12.2125,6048,22994,0.627605,0,2,1481769,1475721,6048
8882021,156.85,10.686,6204,22994,0.630404,0,2,1481925,1475721,6204
8882021,161.244,9.35022,6396,22994,0.652854,0,2,1482117,1475721,6396
8882021,162.088,8.18145,6564,1460,0.687497,0,2,1482285,1475721,6564
8949181,237.558,283.006,2352,7300,0.919556,0,2,1485165,1482813,2352
8949181,237.863,247.63,2592,7300,0.919612,0,2,1485405,1482813,2592
8959401,230.557,305.881,1560,8760,0.957518,0,2,1486509,1484949,1560
8959401,230.237,267.646,1788,10220,0.951578,0,2,1486737,1484949,1788
8995901,196.736,185.201,2024,17520,0.989409,0,2,1493394,1491370,2024
8995901,199.144,162.051,2240,18980,0.950733,0,2,1493610,1491370,2240
8995901,201.251,141.794,2456,20440,0.904392,0,2,1493826,1491370,2456
8995901,203.095,124.07,2672,1460,0.862593,0,2,1494042,1491370,2672
8995901,183.708,108.561,2720,5840,0.828519,0,2,1494090,1491370,2720
8995901,162.244,94.9912,2732,7300,0.798704,0,2,1494102,1491370,2732
8995901,144.964,83.1173,2756,8760,0.775116,0,2,1494126,1491370,2756
8995901,135.843,72.7277,2828,10220,0.749476,0,2,1494198,1491370,2828
8995901,124.863,63.6367,2876,11680,0.722042,0,2,1494246,1491370,2876
8995901,119.755,55.6821,2960,13140,0.703036,0,2,1494330,1491370,2960
8995901,116.786,48.7218,3056,14600,0.683907,0,2,1494426,1491370,3056
8995901,109.687,42.6316,3116,16060,0.657169,0,2,1494486,1491370,3116
9010501,104.977,359.178,613,17520,0.638772,0,2,1494558,1493945,613
9025101,100.854,328.78,569,18980,0.622676,0,2,1494630,1494061,569
9025101,103.248,287.683,689,5840,0.606091,0,2,1494750,1494061,689
9025101,99.3417,251.723,761,5840,0.58908,0,2,1494822,1494061,761
9025101,101.924,220.257,881,5840,0.576695,0,2,1494942,1494061,881
9028021,119.183,250.725,657,5840,0.563358,0,2,1495182,1494525,657
9030941,132.786,248.384,653,24820,0.559188,0,2,1495410,1494757,653
9033861,162.687,270.461,600,27740,0.56804,0,2,1495782,1495182,600
9036781,169.351,259.654,632,30660,0.590785,0,2,1495998,1495366,632
9039701,176.683,250.197,676,30810,0.625687,0,2,1496226,1495550,676
9042621,184.597,241.922,732,30155,0.668726,0,2,1496466,1495734,732
9055761,206.153,7.58619,6112,10220,0.992718,0,2,1502766,1496654,6112
9055761,207.384,6.63792,6328,11680,0.992379,0,2,1502982,1496654,6328
9055761,209.489,1.33699,8956,27271,0.988465,0,2,1505610,1496654,8956
9055761,189.394,0.459402,10396,5840,0.986036,0,2,1507050,1496654,10396
9055761,192.72,0.401977,10612,5840,0.944032,0,2,1507266,1496654,10612
9055761,203.13,0.35173,10888,5840,0.892278,0,2,1507542,1496654,10888
9090801,293.238,1407.56,554,27271,0.854493,0,2,1508466,1507912,554
9095181,280.584,1253.36,572,20076,0.828932,0,2,1508658,1508086,572
9117081,268.011,1118.44,578,20076,0.806565,0,2,1508838,1508260,578
9120001,257.009,1000.39,584,20076,0.796994,0,2,1509018,1508434,584
9130221,251.883,897.089,626,20076,0.80112,0,2,1509234,1508608,626
9131681,242.898,806.703,632,20076,0.80473,0,2,1509414,1508782,632
9133141,235.036,727.615,638,20076,0.820389,0,2,1509594,1508956,638
9144821,205.401,175.66,2156,8760,0.964595,0,2,1512330,1510174,2156
9144821,206.726,153.702,2372,10220,0.950271,0,2,1512546,1510174,2372
9144821,207.885,134.489,2588,11680,0.950237,0,2,1512762,1510174,2588
9166721,185.031,319.622,1136,14600,0.979151,0,2,1514142,1513006,1136
9175481,185.19,87.5492,2613,13140,0.989285,0,2,1516950,1514337,2613
9181321,187.122,96.205,2748,1460,0.984985,0,2,1520022,1517274,2748
9220741,155.359,258.827,840,17520,0.986736,0,2,1521330,1520490,840
9222201,149.439,238.474,852,18980,0.987144,0,2,1521438,1520586,852
9225121,151.759,220.664,924,20440,0.983751,0,2,1521606,1520682,924
9226581,141.789,205.081,900,21900,0.984532,0,2,1521678,1520778,900
9249941,163.589,280.89,1309,14600,0.994063,0,2,1524630,1523321,1309
9249941,201.56,43.3161,4237,16060,0.995334,0,2,1527558,1523321,4237
9292281,221.092,448.44,1244,14600,0.99656,0,2,1530462,1529218,1244
9292281,192.193,154.088,2660,1460,0.995068,0,2,1531878,1529218,2660
9314181,179.276,326.651,891,14600,0.993063,0,2,1533126,1532235,891
9318561,182.366,307.194,924,16060,0.98018,0,2,1533330,1532406,924
9320021,185.07,290.17,957,17520,0.966408,0,2,1533534,1532577,957
9320021,185.937,253.899,1149,18980,0.964357,0,2,1533726,1532577,1149
9320021,182.195,222.161,1305,20440,0.967562,0,2,1533882,1532577,1305
9320021,191.619,87.2419,2656,1460,0.981012,0,2,1535233,1532577,2656
9341921,186.091,226.809,1440,13140,0.992225,0,2,1536673,1535233,1440
9341921,155.171,116.332,2083,6420,0.994762,0,2,1537316,1535233,2083
9341921,150.775,101.791,2203,7880,0.994167,0,2,1537436,1535233,2203
9352721,178.984,317.308,809,1460,0.988034,0,2,1537957,1537148,809
9352721,182.986,277.645,1020,5840,0.97828,0,2,1538168,1537148,1020
9352721,183.488,242.939,1207,5840,0.968495,0,2,1538355,1537148,1207
9352721,162.052,212.572,1219,5840,0.957433,0,2,1538367,1537148,1219
9361481,330.056,240.606,2112,13140,0.971452,0,2,1544675,1542563,2112
9361481,317.299,210.53,2340,14600,0.97002,0,2,1544903,1542563,2340
9396521,217.45,324.961,926,11680,0.996675,0,2,1549019,1548093,926
9396521,227.507,145.841,2342,1460,0.996008,0,2,1550435,1548093,2342
9396521,227.569,127.611,2570,5840,0.994007,0,2,1550663,1548093,2570
9415501,218.758,177.818,1909,11680,0.99487,0,2,1553015,1551106,1909
9415501,218.414,155.591,2125,10220,0.965512,0,2,1553231,1551106,2125
9415501,218.112,136.142,2341,10220,0.919823,0,2,1553447,1551106,2341
9418421,213.348,332.249,816,5840,0.876095,0,2,1553627,1552811,816
9425721,210.679,316.218,804,5840,0.820333,0,2,1553819,1553015,804
9425721,200.844,276.691,936,5840,0.766541,0,2,1553951,1553015,936
9425721,220.739,242.105,1296,5840,0.704474,0,1,1554311,1553015,1296
9428641,242.647,373.842,396,17520,0.652664,0,1,1554707,1554311,396
9428641,230.316,327.111,540,17520,0.612331,0,2,1554851,1554311,540
9428641,219.526,286.222,684,16060,0.58954,0,2,1554995,1554311,684
9428641,207.085,250.445,804,1460,0.577097,0,2,1555115,1554311,804
9428641,187.2,219.139,852,5840,0.57371,0,2,1555163,1554311,852
9430101,183.3,263.747,432,7300,0.580747,0,2,1555319,1554887,432
9440321,184.387,248.778,480,8760,0.601903,0,2,1555511,1555031,480
9440321,171.839,217.681,564,10220,0.617915,0,2,1555595,1555031,564
9440321,174.359,190.471,756,10220,0.641926,0,2,1555787,1555031,756
9452001,222.022,91.7828,2404,11680,0.900075,0,2,1558595,1556191,2404
9452001,222.769,80.3099,2632,11680,0.895065,0,2,1558823,1556191,2632
9452001,223.423,70.2712,2860,11680,0.890682,0,2,1559051,1556191,2860
9497261,235.016,83.6793,3176,1460,0.992417,0,2,1566959,1563783,3176
9497261,279.139,73.2194,3764,5840,0.942115,0,2,1567547,1563783,3764
9507481,254.747,437.067,864,7300,0.8931,0,2,1567631,1566767,864
9510401,239.403,406.434,804,8760,0.846463,0,2,1567763,1566959,804
9516241,228.978,382.379,746,10220,0.799405,0,2,1567919,1567173,746
9516241,215.356,334.582,866,11680,0.748229,0,2,1568039,1567173,866
9519161,221.436,346.259,702,11680,0.698451,0,2,1568303,1567601,702
9522081,225.257,343.227,632,14600,0.657394,0,2,1568555,1567923,632
9525001,231.6,340.573,586,17520,0.62647,0,2,1568831,1568245,586
9526461,254.65,341.752,652,19010,0.606911,0,2,1569247,1568595,652
9527921,248.318,322.658,667,18531,0.604797,0,2,1569451,1568784,667
9529381,245.779,305.951,706,18145,0.607948,0,2,1569679,1568973,706
9530841,240.556,291.332,721,17882,0.618204,0,2,1569883,1569162,721
9532301,238.987,278.54,760,17681,0.647179,0,2,1570111,1569351,760
9533761,236.113,267.348,787,17573,0.682531,0,2,1570327,1569540,787
9562961,213.684,382.857,939,10220,0.976778,0,2,1574555,1573616,939
9568801,216.308,117.656,2495,7300,0.988407,0,2,1577459,1574964,2495
9596541,218.965,198.44,1634,5840,0.980052,0,2,1581335,1579701,1634
9596541,217.094,173.635,1838,4380,0.940046,0,2,1581539,1579701,1838
9596541,228.958,151.93,2150,4380,0.87379,0,2,1581851,1579701,2150
9605301,227.338,337.189,732,18721,0.815816,0,2,1582067,1581335,732
9608221,231.921,322.54,776,5840,0.772589,0,2,1582331,1581555,776
9611141,255.431,346.723,680,8760,0.742266,0,2,1582751,1582071,680
9612601,283.002,358.383,716,11680,0.743232,0,2,1583227,1582511,716
9614061,280.627,341.085,760,13140,0.766578,0,2,1583491,1582731,760
9622821,221.735,102.03,2384,8760,0.957612,0,2,1586303,1583919,2384
9650561,243.066,243.174,1260,20440,0.98628,0,2,1589467,1588207,1260
9650561,211.955,95.4935,2556,8760,0.993362,0,2,1590763,1588207,2556
9653481,200.43,46.9657,3824,13140,0.997854,0,2,1593799,1589975,3824
9653481,196.186,27.5304,4592,5840,0.992492,0,2,1594567,1589975,4592
9653481,195.663,24.0891,4784,5840,0.962181,0,2,1594759,1589975,4784
9653481,196.705,21.078,4988,5840,0.920658,0,2,1594963,1589975,4988
9673921,382.117,784.818,537,22011,0.894326,0,2,1596643,1596106,537
9689981,358.352,706.216,573,23471,0.881285,0,2,1596835,1596262,573
9692901,361.558,637.439,801,24931,0.887375,0,2,1597219,1596418,801
9704581,231.759,171.583,2273,11680,0.973565,0,2,1599871,1597598,2273
9704581,229.789,150.135,2489,13140,0.96812,0,2,1600087,1597598,2489
9707501,204.777,128.998,2412,18980,0.985296,0,2,1601587,1599175,2412
9732321,207.511,267.018,1801,13140,0.990471,0,2,1606322,1604521,1801
9732321,180.974,91.7498,3237,8760,0.995476,0,2,1607758,1604521,3237
9732321,190.477,80.281,3494,10220,0.977291,0,2,1608015,1604521,3494
9732321,187.668,70.2459,3662,11680,0.94388,0,2,1608183,1604521,3662
9732321,179.209,61.4652,3782,5840,0.899645,0,2,1608303,1604521,3782
9732321,168.808,53.782,3878,5840,0.845939,0,2,1608399,1604521,3878
9732321,162.707,47.0593,3998,5840,0.786447,0,2,1608519,1604521,3998
9732321,158.869,41.1769,4130,5840,0.724391,0,1,1608651,1604521,4130
9732321,146.51,36.0298,4190,5840,0.662592,0,1,1608711,1604521,4190
9732321,138.696,31.526,4274,5840,0.608518,0,1,1608795,1604521,4274
9774661,385.609,779.96,369,20440,0.598703,0,2,1610909,1610540,369
9777581,383.908,697.965,617,21900,0.615115,0,2,1611281,1610664,617
9780501,379.42,641.72,717,24820,0.656976,0,2,1611629,1610912,717
9792181,269.539,194.976,2385,8760,0.919789,0,2,1614413,1612028,2385
9792181,264.347,170.604,2613,8760,0.922315,0,2,1614641,1612028,2613
9806781,244.561,436.879,780,10220,0.955136,0,2,1616057,1615277,780
9819921,261.778,323.389,1170,18980,0.973239,0,2,1617469,1616299,1170
9824301,216.707,317.5,1008,11680,0.985704,0,2,1619165,1618157,1008
9825761,216.109,390.206,1070,10220,0.98373,0,2,1621901,1620831,1070
9825761,219.095,341.43,1310,11680,0.933264,0,2,1622141,1620831,1310
9825761,220.208,298.752,1538,13140,0.882856,0,2,1622369,1620831,1538
9825761,225.682,261.408,1802,5840,0.818749,0,2,1622633,1620831,1802
9825761,206.472,228.732,1874,5840,0.765155,0,2,1622705,1620831,1874
9825761,191.163,200.14,1958,5840,0.718261,0,2,1622789,1620831,1958
9825761,176.268,175.123,2030,5840,0.672228,0,2,1622861,1620831,2030
9862261,277.234,495.232,278,1460,0.59195,0,1,1623845,1623567,278
9865181,293.58,468.078,408,24980,0.541706,0,1,1624253,1623845,408
9868101,291.382,439.569,444,27900,0.505243,0,1,1624529,1624085,444
9871021,287.96,414.622,468,27495,0.473338,0,1,1624793,1624325,468
9873941,283.465,392.795,480,26181,0.45292,0,2,1625045,1624565,480
9876861,282.532,373.695,516,25062,0.450055,0,2,1625321,1624805,516
9879781,284.715,356.983,576,24186,0.462548,0,2,1625621,1625045,576
9882701,285.126,342.36,624,26522,0.49598,0,2,1625909,1625285,624
9885621,289.985,329.565,708,26157,0.550232,0,2,1626233,1625525,708
9935261,215.669,399.307,1094,11680,0.986325,0,2,1634789,1633695,1094
9935261,217.364,156.806,2620,20440,0.98463,0,2,1636315,1633695,2620
9935261,220.194,137.206,2860,21900,0.966551,0,2,1636555,1633695,2860
9935261,219.67,120.055,3076,23360,0.939482,0,2,1636771,1633695,3076
9935261,219.211,105.048,3292,24820,0.908297,0,2,1636987,1633695,3292
9935261,202.31,91.917,3376,26280,0.87601,0,2,1637071,1633695,3376
9939641,201.021,426.927,796,27217,0.860259,0,2,1637263,1636467,796
9955701,186.393,387.561,768,27217,0.846476,0,2,1637347,1636579,768
9958621,170.594,353.116,716,28677,0.836917,0,2,1637407,1636691,716
9961541,159.77,322.977,688,30137,0.828552,0,2,1637491,1636803,688
9965921,148.799,296.605,648,30137,0.823733,0,2,1637563,1636915,648
9965921,140.699,259.529,732,30137,0.824516,0,2,1637647,1636915,732
9968841,159.111,255.088,796,30137,0.832702,0,2,1637935,1637139,796
9971761,166.223,251.202,788,30033,0.847364,0,2,1638151,1637363,788
9974681,167.945,242.052,790,29903,0.862694,0,2,1638331,1637541,790
9990741,212.242,206.746,1146,32299,0.932128,0,2,1639755,1638609,1146
9990741,186.212,180.903,1150,32299,0.934362,0,2,1639759,1638609,1150
9996581,158.625,281.85,1229,16060,0.985457,0,2,1642591,1641362,1229
9996581,164.297,246.619,1433,17520,0.986025,0,2,1642795,1641362,1433
9996581,167.76,215.792,1625,18980,0.984022,0,2,1642987,1641362,1625
10041841,211.368,103.092,2592,11680,0.996653,0,2,1647415,1644823,2592
10046221,231.056,396.002,1095,10220,0.987033,0,2,1648663,1647568,1095
10046221,230.674,346.502,1323,5840,0.978654,0,2,1648891,1647568,1323
10046221,228.84,303.189,1539,5840,0.975073,0,2,1649107,1647568,1539
10046221,236.235,265.29,1827,5840,0.961939,0,2,1649395,1647568,1827
10046221,301.206,232.129,2583,5840,0.940446,0,2,1650151,1647568,2583
10046221,352.055,203.113,3291,1460,0.94664,0,2,1650859,1647568,3291
10068121,371.818,482.007,1051,8760,0.961753,0,2,1652091,1651040,1051
10076881,318.554,368.639,1126,17520,0.976633,0,2,1653375,1652249,1126
10078341,307.235,345.184,1173,18980,0.970804,0,2,1653603,1652430,1173
10078341,272.33,302.036,1201,19720,0.971953,0,2,1653631,1652430,1201
10078341,253.376,135.553,2629,10220,0.976163,0,2,1655059,1652430,2629
10078341,250.204,118.608,2857,1460,0.975392,0,2,1655287,1652430,2857
10104621,254.167,301.149,1085,16263,0.980586,0,2,1658127,1657042,1085
10127981,286.265,311.163,1097,5840,0.993958,0,2,1662375,1661278,1097
10129441,301.482,332.893,1020,5840,0.992213,0,2,1662783,1661763,1020
10135281,288.139,302.211,1056,18268,0.987935,0,2,1663839,1662783,1056
10136741,279.122,293.184,1042,18268,0.980694,0,2,1664055,1663013,1042
10138201,272.732,285.286,1040,18268,0.971857,0,2,1664283,1663243,1040
10145501,255.384,258.357,1066,18191,0.980565,0,2,1665459,1664393,1066
10154261,246.768,242.726,1090,18052,0.985028,0,2,1666863,1665773,1090
10155721,244.422,241.136,1088,18052,0.984399,0,2,1667091,1666003,1088
10164481,234.952,234.998,1064,20972,0.990498,0,2,1668447,1667383,1064
10174701,253.86,253.282,1080,24027,0.993877,0,2,1669751,1668671,1080
10176161,247.627,244.622,1100,24027,0.989642,0,2,1669955,1668855,1100
10179081,190.564,103.409,1998,8760,0.991441,0,2,1671221,1669223,1998
10179081,190.743,90.4825,2190,8760,0.990011,0,2,1671413,1669223,2190
10205361,241.668,254.043,1160,18980,0.984238,0,2,1674205,1673045,1160
10206821,239.959,244.788,1208,20440,0.974958,0,2,1674433,1673225,1208
10206821,213.464,214.189,1236,21850,0.976838,0,2,1674461,1673225,1236
10206821,214.77,96.1271,2544,10220,0.988355,0,2,1675769,1673225,2544
10224341,201.721,281.792,1338,5840,0.986677,0,2,1677113,1675775,1338
10224341,205.006,246.568,1566,5840,0.970843,0,2,1677341,1675775,1566
10225801,232.005,327.497,1093,5840,0.963237,0,2,1677762,1676669,1093
10246241,215.887,16.596,5911,11680,0.99852,0,2,1686694,1680783,5911
10246241,219.446,7.44821,7243,14600,0.986836,0,2,1688026,1680783,7243
10246241,222.016,6.51718,7483,16060,0.964731,0,2,1688266,1680783,7483
10246241,218.264,5.70253,7675,17520,0.95539,0,2,1688458,1680783,7675
10246241,223.981,4.98972,7939,18980,0.947216,0,2,1688722,1680783,7939
10246241,209.483,4.366,8047,20440,0.937564,0,2,1688830,1680783,8047
10246241,207.298,3.82025,8239,21859,0.936619,0,2,1689022,1680783,8239
10246241,202.385,3.34272,8407,21859,0.943291,0,2,1689190,1680783,8407
10320701,288.042,628.301,1181,22958,0.986098,0,2,1693470,1692289,1181
10322161,221.477,223.891,2450,10220,0.991473,0,2,1694902,1692452,2450
10325081,223.34,180.261,2352,17520,0.992902,0,2,1696450,1694098,2352
10360121,221.133,279.586,1308,5840,0.998259,0,2,1700842,1699534,1308
10374721,195.692,207.26,1326,13140,0.998152,0,2,1702282,1700956,1326
10398081,215.538,248.707,1126,24820,0.998532,0,2,1705350,1704224,1126
10399541,180.343,81.4761,2402,11680,0.994559,0,2,1706782,1704380,2402
10399541,184.8,71.2916,2618,1460,0.990239,0,2,1706998,1704380,2618
10421441,189.888,272.186,1128,14600,0.994917,0,2,1708354,1707226,1128
10422901,174.839,133.141,1872,13140,0.986754,0,2,1709566,1707694,1872
10422901,181.484,116.498,2100,13140,0.97091,0,2,1709794,1707694,2100
10455021,198.954,271.245,1239,14600,0.990738,0,2,1714222,1712983,1239
10455021,183.383,81.552,2847,8760,0.985965,0,2,1715830,1712983,2847
10455021,193.461,71.358,3111,10220,0.97772,0,2,1716094,1712983,3111
10455021,202.782,11.0041,5727,8760,0.992814,0,2,1718710,1712983,5727
10455021,205.934,9.6286,5955,10220,0.982462,0,2,1718938,1712983,5955
10455021,198.356,7.3719,6303,11680,0.985323,0,2,1719286,1712983,6303
10455021,190.061,6.45041,6435,11680,0.985907,0,2,1719418,1712983,6435
10455021,222.415,1.48483,9099,18537,0.988006,0,2,1722082,1712983,9099
10538241,242.119,579.53,1209,20440,0.996261,0,2,1726050,1724841,1209
10542621,194.092,374.696,1020,13140,0.995266,0,2,1727734,1726714,1020
10542621,195.688,147.142,2400,18980,0.981891,0,2,1729114,1726714,2400
10542621,199.727,128.749,2628,1460,0.976655,0,2,1729342,1726714,2628
10568901,180.146,104.086,2487,26280,0.990994,0,2,1732162,1729675,2487
10568901,186.127,91.0749,2715,1460,0.987119,0,2,1732390,1729675,2715
10593721,183.561,114.069,2328,23360,0.988014,0,2,1734934,1732606,2328
10593721,187.616,99.8107,2544,1460,0.975762,0,2,1735150,1732606,2544
10593721,192.664,87.3344,2772,5840,0.975042,0,2,1735378,1732606,2772
10630221,217.985,154.872,2016,13140,0.994739,0,2,1739878,1737862,2016
10640441,218.122,230.701,1248,7300,0.995666,0,2,1740754,1739506,1248
10649201,212.553,231.592,1089,13140,0.993709,0,2,1741575,1740486,1089
10656501,256.61,265.107,1119,18980,0.988813,0,2,1742819,1741700,1119
10657961,251.534,249.093,1198,20440,0.987711,0,2,1743035,1741837,1198
10657961,220.592,217.957,1202,21900,0.986747,0,2,1743039,1741837,1202
10657961,205.03,85.5907,2570,10220,0.987296,0,2,1744407,1741837,2570
10681321,170.6,132.665,1912,1460,0.993286,0,2,1747071,1745159,1912
10681321,176.275,116.082,2128,5840,0.971625,0,2,1747287,1745159,2128
10681321,179.74,101.572,2332,7300,0.956422,0,2,1747491,1745159,2332
10694461,182.773,260.375,1164,8760,0.948119,0,2,1747695,1746531,1164
10694461,173.426,227.828,1272,10220,0.943354,0,2,1747803,1746531,1272
10694461,154.748,199.35,1296,11680,0.936685,0,2,1747827,1746531,1296
10694461,139.904,174.431,1332,13140,0.928349,0,2,1747863,1746531,1332
10694461,135.916,152.627,1440,13140,0.931056,0,2,1747971,1746531,1440
10697381,138.427,232.549,804,13140,0.938424,0,2,1748127,1747323,804
10697381,130.124,203.48,876,14600,0.939871,0,2,1748199,1747323,876
10703221,124.751,193.946,759,16060,0.950214,0,2,1748415,1747656,759
10716361,200.679,192.301,1157,29200,0.972656,0,2,1749899,1748742,1157
10716361,176.094,168.264,1161,30660,0.971074,0,2,1749903,1748742,1161
10736801,164.355,303.915,1025,14600,0.993635,0,2,1752723,1751698,1025
10736801,176.883,104.428,2501,24820,0.990313,0,2,1754199,1751698,2501
10760161,150.174,297.045,1096,17520,0.987452,0,2,1755567,1754471,1096
10763081,159.902,281.414,1152,18980,0.97902,0,2,1755795,1754643,1152
10777681,138.301,229.094,1220,18980,0.992298,0,2,1758672,1757452,1220
10777681,148.014,200.458,1436,20440,0.990761,0,2,1758888,1757452,1436
10824401,137.952,52.3079,2548,1460,0.99853,0,2,1762728,1760180,2548
10824401,144.708,45.7694,2740,5840,0.996214,0,2,1762920,1760180,2740
10824401,149.12,40.0483,2920,7300,0.995437,0,2,1763100,1760180,2920
10824401,143.98,35.0422,3028,8760,0.992258,0,2,1763208,1760180,3028
10824401,149.982,30.662,3220,10220,0.991975,0,2,1763400,1760180,3220
10834621,132.07,250.994,1088,13140,0.993374,0,2,1763676,1762588,1088
10860901,192.506,263.487,1230,14600,0.998481,0,2,1767924,1766694,1230
10860901,190.28,90.5365,2742,5840,0.989478,0,2,1769436,1766694,2742
10860901,191.995,79.2194,2946,7300,0.985793,0,2,1769640,1766694,2946
10898861,173.966,220.841,1205,20440,0.989479,0,2,1771063,1769858,1205
10922221,182.608,302.66,906,14600,0.98983,0,2,1773835,1772929,906
10928061,186.782,283.578,972,16060,0.982352,0,2,1774051,1773079,972
10928061,188.934,248.13,1176,17520,0.972058,0,2,1774255,1773079,1176
10928061,183.942,217.114,1325,18980,0.9718,0,2,1774404,1773079,1325
10951421,157.37,341.481,949,13140,0.994401,0,2,1776492,1775543,949
10951421,152.699,298.796,1069,14600,0.988851,0,2,1776612,1775543,1069
10951421,156.112,261.447,1249,14600,0.978995,0,2,1776792,1775543,1249
10951421,154.598,228.766,1393,14600,0.96787,0,2,1776936,1775543,1393
10951421,141.273,200.17,1441,14600,0.955637,0,2,1776984,1775543,1441
10951421,146.114,175.149,1621,14600,0.939932,0,2,1777164,1775543,1621
10954341,159.35,265.755,973,14600,0.936191,0,2,1777416,1776443,973
10957261,163.431,270.036,865,17520,0.932917,0,2,1777608,1776743,865
10960181,182.002,273.781,877,20440,0.932552,0,2,1777920,1777043,877
10992301,221.432,162.251,1710,10220,0.990405,0,2,1784028,1782318,1710
10999601,224.472,348.84,977,8760,0.991232,0,2,1785576,1784599,977
10999601,218.152,156.558,2261,16060,0.987315,0,2,1786860,1784599,2261
11025881,206.451,132.92,2484,17520,0.986794,0,2,1789596,1787112,2484
11025881,209.145,116.305,2712,18980,0.968445,0,2,1789824,1787112,2712
11025881,211.502,101.767,2940,20440,0.961139,0,2,1790052,1787112,2940
11027341,206.064,345.546,1056,21900,0.964747,0,2,1790220,1789164,1056
11027341,195.306,302.353,1176,23360,0.960403,0,2,1790340,1789164,1176
11033181,173.893,309.308,842,23360,0.961603,0,2,1790364,1789522,842
11036101,161.156,281.52,827,24820,0.960153,0,2,1790436,1789609,827
11037561,148.512,257.205,800,26280,0.963884,0,2,1790496,1789696,800
11043401,131.517,217.313,782,29200,0.966098,0,2,1790652,1789870,782
11062381,187.29,60.0803,2603,16060,0.994747,0,2,1793604,1791001,2603
11062381,190.879,52.5703,2819,1460,0.987904,0,2,1793820,1791001,2819
443621,227.844,259.624,1291,13140,0.993392,0,2,51482,50191,1291
443621,231.144,101.953,2887,7300,0.992405,0,2,53078,50191,2887
448001,232.251,352.709,1019,8760,0.989604,0,2,53318,52299,1019
448001,205.914,180.908,1919,5840,0.985918,0,2,54218,52299,1919
448001,199.674,158.294,2075,5840,0.963928,0,2,54374,52299,2075
448001,198.715,138.507,2267,18980,0.957187,0,2,54566,52299,2267
528301,236.026,566.996,1005,8760,0.997408,0,2,65294,64289,1005
531221,232.023,524.247,984,10220,0.983982,0,2,65498,64514,984
531221,228.52,458.716,1188,11680,0.983484,0,2,65702,64514,1188
531221,222.455,401.376,1368,11680,0.984299,0,2,65882,64514,1368
531221,218.648,351.204,1560,11680,0.985011,0,2,66074,64514,1560
531221,218.317,307.304,1776,13140,0.985635,0,2,66290,64514,1776
531221,218.028,268.891,1992,14600,0.981181,0,2,66506,64514,1992
531221,214.774,235.279,2184,1460,0.973533,0,2,66698,64514,2184
531221,208.927,205.87,2352,5840,0.971841,0,2,66866,64514,2352
531221,206.811,180.136,2544,7300,0.965361,0,2,67058,64514,2544
531221,204.96,157.619,2736,8760,0.957191,0,2,67250,64514,2736
548741,192.84,393.042,803,10220,0.948792,0,2,67358,66555,803
548741,191.985,343.911,989,11680,0.933943,0,2,67544,66555,989
548741,190.487,300.922,1169,11680,0.91845,0,2,67724,66555,1169
548741,189.176,263.307,1349,11680,0.907394,0,2,67904,66555,1349
551661,209.029,326.394,929,11680,0.89772,0,2,68252,67323,929
554581,227.9,333.594,905,14600,0.891755,0,2,68612,67707,905
557501,250.413,339.895,929,17520,0.894035,0,2,69020,68091,929
558961,269.611,345.408,949,17565,0.906031,0,2,69424,68475,949
570641,229.855,135.691,2131,3220,0.979823,0,2,72142,70011,2131
589921,268.646,270.112,1184,17565,0.968934,0,2,74910,73726,1184
591381,265.065,260.348,1232,17565,0.969067,0,2,75150,73918,1232
591381,240.256,102.237,2736,8760,0.984103,0,2,76654,73918,2736
608901,219.936,306.012,1410,11680,0.992507,0,2,78106,76696,1410
610361,266.475,213.669,2208,7300,0.994907,0,2,79678,77470,2208
617661,252.339,299.085,1392,8760,0.972388,0,2,80842,79450,1392
617661,246.297,261.699,1596,10220,0.939589,0,2,81046,79450,1596
617661,239.51,228.987,1788,10220,0.900891,0,2,81238,79450,1788
617661,230.571,200.364,1956,10220,0.874529,0,2,81406,79450,1956
617661,221.25,175.318,2112,10220,0.853963,0,2,81562,79450,2112
617661,208.593,153.403,2232,11680,0.828468,0,2,81682,79450,2232
617661,202.019,134.228,2388,1460,0.806159,0,2,81838,79450,2388
617661,202.267,117.449,2592,5840,0.786639,0,2,82042,79450,2592
617661,203.983,102.768,2808,7300,0.779559,0,2,82258,79450,2808
632261,184.486,372.047,599,8760,0.773364,0,2,82306,81707,599
632261,188.425,325.541,815,10220,0.770444,0,2,82522,81707,815
632261,193.372,284.849,1043,10220,0.777888,0,2,82750,81707,1043
635181,215.7,320.618,844,10220,0.804402,0,2,83122,82278,844
645401,222.46,127.923,2252,14600,0.941225,0,2,85834,83582,2252
645401,224.652,111.933,2492,16060,0.934822,0,2,86074,83582,2492
660001,204.903,355.627,995,13140,0.970655,0,2,87406,86411,995
680441,204.998,292.275,1248,14600,0.98729,0,2,90502,89254,1248
705261,194.807,137.607,2323,5840,0.993995,0,2,94222,91899,2323
705261,183.956,120.406,2431,5840,0.975995,0,2,94330,91899,2431
705261,190.962,105.355,2671,26096,0.930246,0,2,94570,91899,2671
705261,194.092,92.1859,2887,24582,0.888965,0,2,94786,91899,2887
709641,207.33,385.163,751,24582,0.836595,0,2,95086,94335,751
719861,190.414,357.017,663,24582,0.77827,0,2,95158,94495,663
722781,183.112,332.39,635,24582,0.722236,0,2,95290,94655,635
725701,185.723,310.841,679,24582,0.655707,0,1,95494,94815,679
728621,192.508,311.986,599,23706,0.584994,0,1,95734,95135,599
731541,192.444,312.988,471,22757,0.511869,0,1,95926,95455,471
734461,199.389,313.864,399,21644,0.451636,0,1,96174,95775,399
737381,215.465,314.631,407,20494,0.397681,0,1,96502,96095,407
740301,227.532,315.302,399,19508,0.359221,0,1,96814,96415,399
743221,243.216,315.89,432,18632,0.318068,0,1,97167,96735,432
746141,253.314,316.403,436,17939,0.28956,0,1,97491,97055,436
749061,263.649,316.853,452,17337,0.264615,0,1,97827,97375,452
751981,271.193,317.246,456,16862,0.250288,0,1,98151,97695,456
754901,279.294,317.591,472,16293,0.242752,0,1,98487,98015,472
756361,290.382,318.142,518,15969,0.271158,0,2,98855,98337,518
757821,279.585,298.624,560,17429,0.313513,0,2,99059,98499,560
759281,273.136,281.546,626,18655,0.373074,0,2,99287,98661,626
760741,267.494,266.603,692,18655,0.44769,0,2,99515,98823,692
770961,235.574,104.224,2292,7300,0.865363,0,2,102051,99759,2292
770961,236.127,91.1958,2532,8760,0.858443,0,2,102291,99759,2532
770961,235.111,79.7963,2760,10220,0.871137,0,2,102519,99759,2760
800161,226.685,157.578,2148,8760,0.988558,0,2,106791,104643,2148
819141,231.398,213.017,1564,5840,0.992695,0,2,109563,107999,1564
819141,226.473,186.39,1756,5840,0.972358,0,2,109755,107999,1756
826441,243.164,325.591,816,5840,0.927064,0,2,110115,109299,816
826441,250.268,284.892,1116,16653,0.889931,0,2,110415,109299,1116
826441,230.985,249.281,1212,18113,0.854939,0,2,110511,109299,1212
826441,227.612,218.121,1416,18113,0.826822,0,2,110715,109299,1416
826441,223.16,190.856,1608,18817,0.802219,0,2,110907,109299,1608
826441,220.765,166.999,1812,18817,0.780692,0,2,111111,109299,1812
836661,218.67,322.374,606,18817,0.769355,0,2,111315,110709,606
839581,240.836,306.827,804,18817,0.771936,0,2,111711,110907,804
841041,264.231,317.974,836,18581,0.791694,0,2,112139,111303,836
877541,279.37,324.315,1190,17876,0.985299,0,2,118115,116925,1190
879001,238.188,138.801,2418,10220,0.979227,0,2,119547,117129,2418
889221,238.414,338.201,924,11680,0.963074,0,2,119787,118863,924
889221,218.623,132.81,2364,17520,0.976749,0,2,121227,118863,2364
902361,197.943,161.003,1755,7300,0.96462,0,2,122535,120780,1755
902361,198.7,140.878,1959,7300,0.944042,0,2,122739,120780,1959
902361,193.362,123.268,2115,5840,0.927287,0,2,122895,120780,2115
914041,191.692,280.734,912,5840,0.907626,0,2,123075,122163,912
916961,194.731,265.143,972,5840,0.882923,0,2,123291,122319,972
919881,236.389,304,924,5840,0.841307,0,2,123819,122895,924
922801,241.341,315.5,804,20796,0.814894,0,2,124095,123291,804
924261,272.173,342.062,764,20391,0.801782,0,2,124583,123819,764
925721,266.651,323.555,798,19911,0.807809,0,2,124811,124013,798
970981,266.872,332.647,1136,16060,0.989821,0,2,132431,131295,1136
972441,263.513,315.316,1182,17520,0.986093,0,2,132671,131489,1182
997261,248.182,367.483,1073,5840,0.991063,0,2,136443,135370,1073
998721,270.66,368.048,1129,5840,0.95093,0,2,136871,135742,1129
1000181,265.327,370.667,968,5840,0.903314,0,2,137099,136131,968
1003101,264.536,363.334,915,21270,0.85165,0,2,137358,136443,915
1006021,270.469,371.417,799,21584,0.803944,0,2,137670,136871,799
1008941,271.161,376.74,661,21098,0.764701,0,2,137946,137285,661
1011861,289.765,376.147,709,20391,0.747863,0,2,138366,137657,709
1013321,308.545,375.629,777,19873,0.75313,0,2,138806,138029,777
1014781,296.977,351.925,807,19559,0.770239,0,2,139022,138215,807
1027921,239.253,135.078,2101,7300,0.950757,0,2,141990,139889,2101
1027921,239.346,118.193,2341,7300,0.939412,0,2,142230,139889,2341
1052741,229.844,244.732,1620,10220,0.992023,0,2,146322,144702,1620
1052741,287.428,143.457,3096,5840,0.990324,0,2,147798,144702,3096
1070261,286.937,339.018,1196,13140,0.993787,0,2,149222,148026,1196
1070261,234.391,152.15,2316,5840,0.990962,0,2,150342,148026,2316
1070261,233.592,133.131,2544,5840,0.957092,0,2,150570,148026,2544
1073181,229.893,330.99,1032,5840,0.927455,0,2,150774,149742,1032
1074641,225.156,339.116,828,5840,0.900273,0,2,150966,150138,828
1084861,216.512,322.227,780,16060,0.866489,0,2,151122,150342,780
1087781,231.448,310.448,888,23901,0.846928,0,2,151458,150570,888
1090701,237.017,321.142,768,23639,0.829812,0,2,151734,150966,768
1092161,250.39,319.999,800,23134,0.824835,0,2,152078,151278,800
1095081,237.591,299.499,792,22778,0.822981,0,2,152226,151434,792
1098001,249.892,301.062,816,22441,0.841358,0,2,152562,151746,816
1111141,228.397,131.081,2064,7300,0.955547,0,2,155490,153426,2064
1111141,229.847,114.696,2304,7300,0.957354,0,2,155730,153426,2304
1119901,227.453,2.14395,9036,5840,0.970983,0,2,164058,155022,9036
1181221,280.769,100.286,5110,17520,0.995962,0,2,173017,167907,5110
1181221,262.551,10.3604,9526,18249,0.985833,0,2,177433,167907,9526
1181221,259.732,9.06537,9766,18249,0.975104,0,2,177673,167907,9766
1181221,254.266,7.9322,9982,18249,0.976966,0,2,177889,167907,9982
1181221,262.983,6.94067,10306,18249,0.973595,0,2,178213,167907,10306
1181221,258.61,6.07309,10534,18249,0.975646,0,2,178441,167907,10534
1181221,245.784,5.31395,10690,5840,0.97244,0,2,178597,167907,10690
1242541,315.753,1137.46,888,15334,0.984614,0,2,180553,179665,888
1287801,279.649,336.168,1120,16060,0.997286,0,2,189105,187985,1120
1289261,242.355,126.506,2676,5840,0.997817,0,2,190885,188209,2676
1312621,252.347,304.478,1058,18980,0.994498,0,2,193605,192547,1058
1314081,249.304,293.168,1072,20440,0.978935,0,2,193833,192761,1072
1315541,245.141,283.272,1074,21900,0.980318,0,2,194049,192975,1074
1362261,243.842,292.67,1220,11680,0.997226,0,2,201297,200077,1220
1365181,214.22,312.064,1032,5840,0.995297,0,2,202801,201769,1032
1381241,203.776,232.986,1177,14600,0.995653,0,2,204193,203016,1177
1422121,202.749,84.9717,2785,8760,0.986219,0,2,211633,208848,2785
1448401,220.391,599.725,927,8760,0.996321,0,2,214453,213526,927
1465921,235.518,366.708,984,1460,0.996852,0,2,217657,216673,984
1465921,236.078,320.87,1224,5840,0.988495,0,2,217897,216673,1224
1465921,237.935,245.666,1716,8760,0.987442,0,2,218389,216673,1716
1470301,235.193,346.833,877,8760,0.980261,0,2,218605,217728,877
1470301,229.794,303.479,1069,10220,0.978979,0,2,218797,217728,1069
1473221,244.57,318.044,997,10220,0.970356,0,2,219145,218148,997
1474681,270.498,337.288,977,13140,0.957812,0,2,219597,218620,977
1477601,262.686,321.252,976,14600,0.944335,0,2,219805,218829,976
1480521,277.85,333.346,942,17520,0.927543,0,2,220189,219247,942
1483441,294.119,343.927,932,19351,0.91285,0,2,220597,219665,932
1486361,306.854,353.187,910,19206,0.899994,0,2,220993,220083,910
1487821,318.997,361.288,896,19050,0.893745,0,2,221397,220501,896
1489281,306.123,342.252,903,20105,0.893277,0,2,221613,220710,903
1490741,296.357,325.596,922,19957,0.895367,0,2,221841,220919,922
1492201,286.313,311.021,929,19859,0.903446,0,2,222057,221128,929
1493661,277.524,298.269,936,19785,0.913016,0,2,222273,221337,936
1514101,284.841,275.81,1134,21096,0.970866,0,2,225093,223959,1134
1515561,205.922,90.2692,2443,10220,0.976241,0,2,226573,224130,2443
1515561,205.682,78.9856,2647,1460,0.970461,0,2,226777,224130,2647
1536001,194.98,300.806,1040,13140,0.985493,0,2,227917,226877,1040
1536001,196.107,263.205,1244,13140,0.974806,0,2,228121,226877,1244
1547681,222.164,162.85,2481,1460,0.994506,0,2,232381,229900,2481
1578341,220.302,325.157,984,20440,0.997098,0,2,234169,233185,984
1591481,212.46,117.635,2344,11680,0.989416,0,2,236893,234549,2344
1591481,214.403,102.931,2572,13140,0.989489,0,2,237121,234549,2572
1630901,188.938,246.072,1291,17520,0.996943,0,2,241405,240114,1291
1636741,227.636,95.7973,3295,8760,0.983565,0,2,245869,242574,3295
1636741,229.181,83.8226,3535,10220,0.979369,0,2,246109,242574,3535
1636741,229.034,73.3448,3763,10220,0.980698,0,2,246337,242574,3763
1636741,212.405,64.1767,3859,11680,0.979361,0,2,246433,242574,3859
1679081,211.637,180.775,2739,5840,0.988134,0,2,250609,247870,2739
1695141,232.071,322.902,1208,11680,0.990925,0,2,252045,250837,1208
1709741,196.795,128.826,2436,1460,0.9907,0,2,256129,253693,2436
1743321,175.394,78.8047,2706,5840,0.994924,0,2,262021,259315,2706
1762301,146.168,155.648,1822,21900,0.991478,0,2,263617,261795,1822
1762301,231.275,0.745533,10486,24363,0.986209,0,2,272281,261795,10486
1762301,220.537,0.0264648,16006,24363,0.99701,0,2,277801,261795,16006
1904481,921.488,1207.25,1214,19127,0.998397,0,2,301195,299981,1214
1936601,257.02,270.264,1115,20546,0.993693,0,2,307107,305992,1115
1938061,251.892,260.481,1139,20546,0.988231,0,2,307323,306184,1139
1939521,248.906,251.921,1175,21520,0.987203,0,2,307551,306376,1175
1957041,248.524,64.1498,4277,11680,0.992046,0,2,313159,308882,4277
1957041,247.459,56.1311,4517,13140,0.98679,0,2,313399,308882,4517
1977481,250.382,560.91,1143,10220,0.992821,0,2,314923,313780,1143
1983321,277.13,457.844,1115,14600,0.994542,0,2,316227,315112,1115
1984781,272.489,428.363,1133,16060,0.991474,0,2,316467,315334,1133
2032961,235.391,281.183,1132,17520,0.991203,0,2,325155,324023,1132
2034421,216.42,122.537,2312,5840,0.985296,0,2,326551,324239,2312
2049021,252.771,137.008,2511,5840,0.995365,0,2,329383,326872,2511
2078221,243.27,252.614,1121,18916,0.987021,0,2,333687,332566,1121
2081141,245.681,126.97,2343,1460,0.992403,0,2,335371,333028,2343
2101581,284.933,323.097,1078,17520,0.994251,0,2,338355,337277,1078
2117641,229.507,268.8,1086,11680,0.993987,0,2,341119,340033,1086
2126401,246.818,268.313,1034,18030,0.988551,0,2,342747,341713,1034
2143921,247.27,245.703,1094,17714,0.996444,0,2,345687,344593,1094
2164361,231.736,94.0572,2634,1460,0.996004,0,2,350347,347713,2634
2180421,214.873,279.269,1369,11680,0.989457,0,2,351559,350190,1369
2196481,244.012,300.154,1114,8760,0.996323,0,2,354303,353189,1114
2196481,219.884,229.806,1382,10220,0.995935,0,2,354571,353189,1382
2247581,198.812,121.679,2232,11680,0.998725,0,2,363303,361071,2232
2279701,218.893,488.919,1274,14600,0.997423,0,2,368019,366745,1274
2279701,206.712,219.425,2462,5840,0.993843,0,2,369207,366745,2462
2279701,209.373,191.997,2690,1460,0.977113,0,2,369435,366745,2690
2303061,211.839,193.86,1790,8760,0.987232,0,2,371979,370189,1790
2303061,215.359,169.628,2030,8760,0.983828,0,2,372219,370189,2030
2303061,214.689,148.424,2240,10220,0.979599,0,2,372429,370189,2240
2311821,214.853,323.621,906,11680,0.980899,0,2,372645,371739,906
2311821,216.357,127.085,2406,1460,0.979999,0,2,374145,371739,2406
2341021,243.238,269.209,1103,21900,0.995225,0,2,377333,376230,1103
2342481,224.894,117.386,2339,1460,0.980625,0,2,378777,376438,2339
2342481,225.282,102.713,2567,5840,0.978047,0,2,379005,376438,2567
2360001,255.122,313.803,1051,13140,0.98124,0,2,380417,379366,1051
2389201,210.914,88.159,2743,1460,0.995908,0,2,386985,384242,2743
2389201,214.549,77.1391,2983,5840,0.97767,0,2,387225,384242,2983
2389201,217.731,67.4968,3223,7300,0.967961,0,2,387465,384242,3223
2421321,225.881,120.325,2374,7300,0.989604,0,2,391497,389123,2374
2437381,205.852,246.116,1136,11680,0.985917,0,2,392877,391741,1136
2437381,210.12,215.352,1376,11680,0.970178,0,2,393117,391741,1376
2495781,243.109,155.561,2209,5840,0.997444,0,2,404874,402665,2209
2495781,242.72,136.116,2449,7300,0.984013,0,2,405114,402665,2449
2495781,240.88,119.102,2677,1460,0.974762,0,2,405342,402665,2677
2516221,279.189,324.063,1083,5840,0.990078,0,2,407762,406679,1083
2517681,272.79,315.93,1052,5840,0.990068,0,2,407990,406938,1052
2524981,275.255,292.626,1090,16726,0.979906,0,2,409370,408280,1090
2526441,270.848,288.423,1071,16726,0.972418,0,2,409610,408539,1071
2529361,264.492,284.745,1032,16726,0.972115,0,2,409830,408798,1032
2552721,267.945,255.192,1151,19903,0.994208,0,2,414254,413103,1151
2564401,224.219,155.21,2028,11680,0.993979,0,2,416970,414942,2028
2564401,226.191,135.808,2268,11680,0.988482,0,2,417210,414942,2268
2589221,201.241,295.629,1136,13140,0.996459,0,2,421110,419974,1136
2608201,262.796,282.647,1113,5840,0.986568,0,2,424082,422969,1113
2609661,256.946,269.441,1152,5840,0.981997,0,2,424298,423146,1152
2625721,264.356,266.076,1078,19143,0.994014,0,2,427046,425968,1078
2627181,258.311,259.567,1080,19143,0.992262,0,2,427262,426182,1080
2650541,244.801,258.528,1130,17520,0.998051,0,2,431450,430320,1130
2689961,231.712,319.106,960,1460,0.992447,0,2,437430,436470,960
2691421,256.248,310.718,1136,22055,0.992141,0,2,437858,436722,1136
2698721,214.079,124.309,2246,10220,0.992538,0,2,440780,438534,2246
2716241,237.072,299.098,1058,8760,0.986876,0,2,441806,440748,1058
2716241,234.438,261.711,1274,11680,0.969766,0,2,442022,440748,1274
2716241,231.134,228.997,1482,11680,0.958546,0,2,442230,440748,1482
2716241,220.242,200.372,1626,11680,0.943727,0,2,442374,440748,1626
2716241,198.712,175.326,1674,11680,0.933262,0,2,442422,440748,1674
2719161,218.873,286.41,970,11680,0.912854,0,2,442782,441812,970
2722081,236.639,300.609,931,14600,0.896247,0,2,443143,442212,931
2725001,246.059,308.033,883,17520,0.882966,0,2,443455,442572,883
2727921,255.051,309.529,881,20440,0.873845,0,2,443773,442892,881
2729381,266.17,312.338,893,23246,0.875865,0,2,444117,443224,893
2732301,252.899,294.045,887,23007,0.882632,0,2,444277,443390,887
2746901,209.349,85.6749,2650,1460,0.982913,0,2,447765,445115,2650
2776101,201.182,111.321,2387,8760,0.980067,0,2,451911,449524,2387
2800921,198.472,135.773,2004,11680,0.987647,0,2,455103,453099,2004
2800921,204.056,79.5875,2868,24029,0.987759,0,2,455967,453099,2868
2806761,225.049,374.139,804,25380,0.956789,0,2,456339,455535,804
2814061,214.918,346.872,792,25380,0.92344,0,2,456483,455691,792
2814061,209.053,303.513,960,25380,0.89176,0,2,456651,455691,960
2816981,214.421,304.574,900,25380,0.85654,0,2,456903,456003,900
2819901,211.619,305.502,780,24968,0.825723,0,2,457095,456315,780
2822821,219.666,306.314,744,24332,0.801257,0,2,457371,456627,744
2825741,232.708,307.025,756,23695,0.79985,0,2,457695,456939,756
2827201,248.12,307.647,800,23153,0.823619,0,2,458051,457251,800
2853481,234.597,358.252,1343,11680,0.990539,0,2,465255,463912,1343
2891441,231.63,179.799,2240,5840,0.986645,0,2,469419,467179,2240
2891441,232.676,157.324,2480,5840,0.957064,0,2,469659,467179,2480
2894361,230.592,369.659,840,1460,0.938681,0,2,469875,469035,840
2895821,225.768,345.951,852,22878,0.922596,0,2,470067,469215,852
2904581,212.547,328.207,768,22878,0.913522,0,2,470187,469419,768
2906041,230.978,317.181,888,22878,0.903081,0,2,470547,469659,888
2906041,221.606,277.534,1044,22878,0.891446,0,2,470703,469659,1044
2906041,217.905,242.842,1236,22878,0.891265,0,2,470895,469659,1236
2906041,211.667,212.487,1404,22878,0.893607,0,2,471063,469659,1404
2929401,222.666,312.263,1290,13140,0.988887,0,2,475755,474465,1290
2929401,232.559,140.142,2766,5840,0.992512,0,2,477231,474465,2766
2957141,245.617,174.219,2232,13140,0.994323,0,2,481623,479391,2232
2957141,232.147,89.3585,3336,8760,0.983338,0,2,482727,479391,3336
2974661,230.128,388.689,1068,10220,0.932921,0,2,482943,481875,1068
2977581,229.862,369.728,1059,11680,0.892556,0,2,483171,482112,1059
2977581,220.629,323.512,1215,13140,0.857236,0,2,483327,482112,1215
2977581,214.051,283.073,1383,13140,0.823832,0,2,483495,482112,1383
2977581,193.294,247.689,1431,14600,0.794603,0,2,483543,482112,1431
2977581,190.133,216.728,1599,16060,0.766527,0,2,483711,482112,1599
2977581,191.866,189.637,1803,17520,0.741962,0,2,483915,482112,1803
2977581,187.383,165.932,1959,18980,0.727966,0,2,484071,482112,1959
2977581,181.96,145.191,2103,20440,0.720721,0,2,484215,482112,2103
2977581,186.215,127.042,2319,21900,0.714381,0,2,484431,482112,2319
2977581,191.438,111.161,2547,23360,0.721333,0,2,484659,482112,2547
2977581,193.008,97.2663,2751,1460,0.734916,0,2,484863,482112,2751
2977581,189.882,85.108,2919,5840,0.754302,0,2,485031,482112,2919
2977581,194.647,74.4695,3147,7300,0.771264,0,2,485259,482112,3147
2977581,186.816,65.1608,3279,8760,0.793606,0,2,485391,482112,3279
3000941,169.464,384.391,708,10220,0.818155,0,2,485439,484731,708
3040361,234.302,237.027,1270,17520,0.992465,0,2,492733,491463,1270
3040361,210.014,207.399,1310,18980,0.988407,0,2,492773,491463,1310
3040361,190.978,81.4447,2588,11680,0.991697,0,2,494051,491463,2588
3059681,340.258,443.967,938,1460,0.985897,0,2,496805,495867,938
3061141,419.475,505.721,974,5840,0.98391,0,2,497779,496805,974
3064061,390.041,467.506,958,7300,0.979671,0,2,497963,497005,958
3074281,289.33,185.866,2226,7300,0.987821,0,2,501005,498779,2226
3090341,235.078,160.084,1985,8760,0.992853,0,2,503909,501924,1985
3099101,232.048,183.879,1824,10220,0.995543,0,2,505277,503453,1824
3099101,254.087,42.3273,4632,13140,0.987724,0,2,508085,503453,4632
3099101,252.326,37.0364,4872,1460,0.986758,0,2,508325,503453,4872
3123921,264.709,489.511,1112,5840,0.951557,0,2,509881,508769,1112
3125381,258.621,456.072,1106,5840,0.916363,0,2,510097,508991,1106
3128301,244.793,426.813,1032,16060,0.893067,0,2,510245,509213,1032
3131221,275.694,456.962,856,18980,0.882684,0,2,510737,509881,856
3134141,280.232,445.342,804,21900,0.873598,0,2,511049,510245,804
3137061,288.703,426.674,856,24820,0.883149,0,2,511397,510541,856
3150201,243.799,145.298,2304,10220,0.970214,0,2,514325,512021,2304
3166261,233.637,196.618,2132,18980,0.991501,0,2,517085,514953,2132
3201301,218.737,346.474,1064,13140,0.989412,0,2,521501,520437,1064
3201301,221.395,303.165,1304,14600,0.989485,0,2,521741,520437,1304
3201301,218.138,136.059,2588,1460,0.987781,0,2,523025,520437,2588
3201301,219.371,119.051,2816,5840,0.968058,0,2,523253,520437,2816
3208601,253.449,413.92,830,5840,0.968301,0,2,523745,522915,830
3227581,223.438,160.853,1941,10220,0.990203,0,2,526181,524240,1941
3227581,224.008,140.746,2169,11680,0.985178,0,2,526409,524240,2169
3227581,220.007,123.153,2361,13140,0.982031,0,2,526601,524240,2361
3258241,217.923,292.327,1038,11680,0.997506,0,2,530741,529703,1038
3258241,217.683,255.786,1254,13140,0.990318,0,2,530957,529703,1254
3304961,247.946,375.903,1237,34056,0.997199,0,2,536929,535692,1237
3304961,220.452,328.915,1265,34056,0.996299,0,2,536957,535692,1265
3304961,175.257,113.018,2477,13140,0.989978,0,2,538169,535692,2477
3304961,181.85,98.8909,2705,13140,0.971231,0,2,538397,535692,2705
3325401,212.939,56.9222,3694,11680,0.997008,0,2,542669,538975,3694
3377961,286.315,474.219,1021,16970,0.994819,0,2,548477,547456,1021
3377961,280.526,414.942,1261,16970,0.984216,0,2,548717,547456,1261
3392561,244.441,235.198,1692,10220,0.993071,0,2,551597,549905,1692
3399861,272.12,306.858,1113,16060,0.995196,0,2,553141,552028,1113
3415921,237.748,275.189,1124,10220,0.984153,0,2,556049,554925,1124
3439281,278.354,285.008,1026,15418,0.989379,0,2,560689,559663,1026
3446581,285.48,283.543,1068,16918,0.983302,0,2,562141,561073,1068
3455341,273.487,269.463,1080,18086,0.988756,0,2,563701,562621,1080
3456801,259.18,135.68,2306,5840,0.987454,0,2,565157,562851,2306
3483081,295.097,299.363,1054,15115,0.994315,0,2,569401,568347,1054
3484541,288.21,297.943,1006,15115,0.993776,0,2,569641,568635,1006
3506441,280.163,270.197,1108,18086,0.99666,0,2,573889,572781,1108
3507901,272.142,265.172,1094,18086,0.994578,0,2,574105,573011,1094
3529801,252.207,250.694,1059,21340,0.997794,0,2,577381,576322,1059
3531261,249.181,241.232,1112,21340,0.98182,0,2,577609,576497,1112
3532721,245.033,232.953,1153,21340,0.982843,0,2,577825,576672,1153
3532721,219.404,203.834,1193,21694,0.983737,0,2,577865,576672,1193
3532721,199.624,91.4797,2287,8760,0.981451,0,2,578959,576672,2287
3544401,201.671,272.92,960,1460,0.97877,0,2,579175,578215,960
3544401,201.962,238.805,1164,5840,0.978924,0,2,579379,578215,1164
3569221,217.689,308.104,708,4380,0.985323,0,2,583131,582423,708
3577981,262.079,267.858,1148,24981,0.986222,0,2,584711,583563,1148
3582361,221.454,125.761,2376,14600,0.986891,0,2,587631,585255,2376
3608641,215.853,271.285,1361,13140,0.992996,0,2,589311,587950,1361
3627621,218.137,266.253,1180,14600,0.99392,0,2,592247,591067,1180
3627621,195.87,232.972,1220,16060,0.99343,0,2,592287,591067,1220
3627621,192.271,91.487,2540,10220,0.98867,0,2,593607,591067,2540
3664121,185.664,266.317,1305,16060,0.97829,0,2,598095,596790,1305
3696241,152.829,229.383,894,17520,0.987247,0,2,601116,600222,894
3696241,141.933,60.3451,2226,32120,0.984145,0,2,602448,600222,2226
3696241,118.861,18.1432,3263,16060,0.993983,0,2,603485,600222,3263
3700621,105.503,316.5,870,17520,0.993485,0,2,603497,602627,870
3715221,99.8151,287.688,844,18980,0.99305,0,2,603557,602713,844
3719601,231.393,2.93245,8033,17520,0.998685,0,2,610918,602885,8033
3719601,230.969,2.5659,8261,18980,0.99385,0,2,611146,602885,8261
3751721,195.416,1453.35,1087,11680,0.99475,0,2,615598,614511,1087
3783841,208.181,188.597,2977,1460,0.997222,0,2,620086,617109,2977
3883121,192.645,208.246,1500,10220,0.997466,0,2,626522,625022,1500
3888961,194.065,288.591,853,11680,0.992783,0,2,626726,625873,853
3929841,198.83,126.553,2401,1460,0.984995,0,2,638288,635887,2401
3929841,203.976,110.734,2641,5840,0.98062,0,2,638528,635887,2641
3976561,212.053,263.494,1093,11680,0.982723,0,2,642632,641539,1093
3976561,247.443,20.8412,5497,7300,0.984883,0,2,647036,641539,5497
3978021,239.443,352.123,2211,14600,0.990716,0,2,648428,646217,2211
4033501,312.634,411.36,1105,20440,0.992318,0,2,652588,651483,1105
4034961,302.055,382.44,1153,21900,0.965779,0,2,652816,651663,1153
4036421,292.798,369.76,1100,22694,0.955056,0,2,653044,651944,1100
4036421,259.698,323.54,1128,22694,0.945674,0,2,653072,651944,1128
4036421,252.736,283.097,1332,22694,0.948715,0,2,653276,651944,1332
4036421,243.644,247.71,1512,22694,0.953875,0,2,653456,651944,1512
4036421,234.188,216.746,1680,7300,0.958391,0,2,653624,651944,1680
4084601,225.406,129.293,2368,5840,0.996076,0,2,663212,660844,2368
4094821,227.231,316.131,984,5840,0.992816,0,2,663452,662468,984
4109421,241.198,327.345,923,10220,0.99311,0,2,665996,665073,923
4109421,238.049,286.427,1139,11680,0.991471,0,2,666212,665073,1139
4147381,259.035,260.187,1087,23698,0.99441,0,2,671584,670497,1087
4179501,216.308,101.65,2485,11680,0.989867,0,2,677708,675223,2485
4195561,192.167,265.191,1018,13140,0.985268,0,2,679172,678154,1018
4195561,195.146,232.042,1234,14600,0.97836,0,2,679388,678154,1234
4195561,181.459,69.7652,2830,5840,0.992244,0,2,680984,678154,2830
4223301,266.887,47.9743,5426,1460,0.998539,0,2,688892,683466,5426
4256881,245.424,437.176,1416,13140,0.996926,0,2,690512,689096,1416
4256881,240.75,171.677,3072,8760,0.997543,0,2,692168,689096,3072
4256881,244.484,88.0547,4320,11680,0.99624,0,2,693416,689096,4320
4256881,242.423,77.0479,4548,13140,0.99046,0,2,693644,689096,4548
4256881,274.773,7.95971,8868,15027,0.992764,0,2,697964,689096,8868
4256881,268.926,6.96475,9096,15027,0.986169,0,2,698192,689096,9096
4316741,324.465,671.643,1090,17520,0.982117,0,2,703444,702354,1090
4318201,313.907,627.313,1013,17602,0.978102,0,2,703684,702671,1013
4326961,281.874,425.58,998,17418,0.988922,0,2,705256,704258,998
4370761,262.672,316.522,1096,17520,0.998574,0,2,712632,711536,1096
4388281,237.374,250.487,1048,18766,0.994672,0,2,715224,714176,1048
4397041,236.024,233.682,1132,5840,0.983859,0,2,716628,715496,1132
4405801,252.079,249.951,1104,19072,0.991506,0,2,718212,717108,1104
4416021,211.467,86.5909,2576,1460,0.99244,0,2,721180,718604,2576
4416021,215.034,75.767,2816,5840,0.983385,0,2,721420,718604,2816
4439381,199.548,118.387,2153,11680,0.993038,0,2,724540,722387,2153
4459821,215.765,29.1093,4488,16060,0.997284,0,2,729424,724936,4488
4489021,206.352,592.439,1101,11680,0.987531,0,2,730672,729571,1101
4489021,209.058,518.384,1329,13140,0.97659,0,2,730900,729571,1329
4506541,213.433,290.165,1226,13140,0.99389,0,2,733728,732502,1226
4508001,199.961,107.164,2554,14600,0.990401,0,2,735208,732654,2554
4524061,170.761,110.465,2416,27740,0.995258,0,2,738040,735624,2416
4547421,174.11,93.4676,2672,1460,0.998375,0,2,741172,738500,2672
4567861,167.113,237.397,1332,16860,0.998261,0,2,742618,741286,1332
4567861,254.937,81.5718,4032,13140,0.998153,0,2,745318,741286,4032
4593481,225.352,317.262,1905,16060,0.994751,0,2,748642,746737,1905
4593481,250.51,162.726,3285,8760,0.993558,0,2,750022,746737,3285
4593481,247.696,142.385,3513,10220,0.984363,0,2,750250,746737,3513
4619761,277.403,688.184,1050,10220,0.992799,0,2,752950,751900,1050
4619761,266.706,308.854,2610,1460,0.991768,0,2,754510,751900,2610
4692761,252.647,423.776,1140,16060,0.99372,0,2,764760,763620,1140
4717581,255.051,306.796,1181,17520,0.990815,0,2,769430,768249,1181
4717581,228.169,268.446,1221,18980,0.980713,0,2,769470,768249,1221
4732181,239.357,304.497,1397,10220,0.98806,0,2,772182,770785,1397
4732181,248.738,136.657,2933,7300,0.982142,0,2,773718,770785,2933
4742401,247.645,403.575,901,8760,0.981874,0,2,773958,773057,901
4751161,233.616,163.521,2023,7300,0.992599,0,2,776766,774743,2023
4751161,232.914,143.081,2251,1460,0.989774,0,2,776994,774743,2251
4761381,232.3,321.07,912,5840,0.989802,0,2,777222,776310,912
4775981,232.374,110.476,2455,8760,0.991578,0,2,781338,778883,2455
4803721,232.334,309.06,1374,11680,0.99574,0,2,785994,784620,1374
4803721,233.292,270.427,1614,11680,0.995023,0,2,786234,784620,1614
4803721,239.327,138.705,2879,7300,0.996197,0,2,787499,784620,2879
4808101,226.607,209.367,2004,16060,0.988507,0,2,789040,787036,2004
4808101,226.781,183.196,2232,1460,0.983693,0,2,789268,787036,2232
4808101,218.254,140.26,2616,5840,0.982515,0,2,789652,787036,2616
4808101,212.472,122.727,2788,5840,0.982201,0,2,789824,787036,2788
4808101,206.413,107.386,2952,18980,0.976926,0,2,789988,787036,2952
4828541,191.112,368.213,842,20440,0.97231,0,2,790072,789230,842
4831461,187.348,342.436,841,21900,0.967021,0,2,790233,789392,841
4838761,183.429,319.882,835,23360,0.967394,0,2,790389,789554,835
4838761,177.001,279.897,967,24820,0.958969,0,2,790521,789554,967
4838761,172.876,244.91,1111,24820,0.956598,0,2,790665,789554,1111
4841681,187.266,270.921,946,24820,0.959523,0,2,790953,790007,946
4847521,181.563,257.893,841,30660,0.96526,0,2,791284,790443,841
4850441,178.368,242.406,863,33580,0.965853,0,2,791440,790577,863
4853361,171.072,228.855,849,36500,0.961371,0,2,791560,790711,849
4856281,172.188,216.998,895,39420,0.96245,0,2,791740,790845,895
4859201,162.664,206.624,857,42340,0.960893,0,2,791836,790979,857
4926361,224.969,206.268,1824,16060,0.997457,0,2,801707,799883,1824
4949721,208.743,354,1044,5840,0.990251,0,2,803111,802067,1044
4949721,212.651,309.75,1284,5840,0.98772,0,2,803351,802067,1284
4958481,462.811,601.465,720,20440,0.976848,0,2,805991,805271,720
4968701,433.459,545.032,798,21900,0.969742,0,2,806219,805421,798
4968701,288.475,214.032,2178,1460,0.984368,0,2,807599,805421,2178
4994981,269.474,297.71,1190,20440,0.986402,0,2,810295,809105,1190
5011041,234.251,116.12,2647,1460,0.994059,0,2,814669,812022,2647
5032941,172.955,84.6793,2416,16060,0.990713,0,2,817765,815349,2416
5035861,189.639,294.317,1265,5840,0.994309,0,2,819373,818108,1265
5069441,273.634,324.15,1059,26280,0.990544,0,2,822069,821010,1059
5070901,254.852,20.3738,5489,17520,0.998177,0,2,826585,821096,5489
5070901,223.594,8.00069,6881,13140,0.994284,0,2,827977,821096,6881
5070901,255.94,4.10363,8261,17520,0.994568,0,2,829357,821096,8261
5104481,312.238,1298.3,927,18939,0.988109,0,2,833857,832930,927
5139521,303.208,1163.76,945,20399,0.970845,0,2,834097,833152,945
5139521,293.807,1018.29,1173,21859,0.969489,0,2,834325,833152,1173
5139521,258.025,522.29,2289,7300,0.983101,0,2,835441,833152,2289
5155581,231.238,438.043,1343,11680,0.989614,0,2,836929,835586,1343
5177481,270.759,291.508,1146,16449,0.997349,0,2,840981,839835,1146
5180401,262.347,284.826,1089,16449,0.99547,0,2,841450,840361,1089
5184781,257.721,277.622,1039,16449,0.994465,0,2,842189,841150,1039
5186241,258.505,275.794,1040,16449,0.988907,0,2,842453,841413,1040
5187701,259.192,274.195,1041,16449,0.985294,0,2,842717,841676,1041
5200841,274.404,287.021,983,19556,0.992975,0,2,844657,843674,983
5206681,275.525,272.031,1091,20486,0.983382,0,2,845809,844718,1091
5208141,266.585,261.777,1105,20486,0.975459,0,2,846013,844908,1105
5231501,273.742,316.547,1067,17520,0.995853,0,2,849925,848858,1067
5232961,266.524,305.479,1055,18121,0.987621,0,2,850141,849086,1055
5260701,252.336,259.941,1055,21041,0.987631,0,2,854473,853418,1055
5262161,247.794,255.949,1043,21041,0.984177,0,2,854689,853646,1043
5276761,237.873,190.475,1604,19929,0.982211,0,2,857633,856029,1604
5286981,282.395,296.533,1070,21306,0.989626,0,2,859294,858224,1070
5288441,274.096,285.967,1074,22711,0.980923,0,2,859510,858436,1074
5308881,224.459,205.003,1620,11680,0.996498,0,2,863282,861662,1620
5308881,235.614,92.0043,3072,7300,0.988428,0,2,864734,861662,3072
5330781,224.982,136.682,2337,8760,0.996419,0,2,867506,865169,2337
5330781,226.86,119.596,2577,1460,0.990617,0,2,867746,865169,2577
5330781,228.502,104.647,2817,5840,0.99054,0,2,867986,865169,2817
5364361,219.533,274.685,1139,21900,0.995273,0,2,871898,870759,1139
5364361,222.092,240.35,1379,21900,0.988364,0,2,872138,870759,1379
5364361,210.843,107.868,2615,5840,0.993528,0,2,873374,870759,2615
5367281,211.488,322.259,1008,7300,0.986837,0,2,873590,872582,1008
5377501,212.052,314.977,960,8760,0.983482,0,2,873806,872846,960
5397941,241.719,289.243,1047,10220,0.98555,0,2,877886,876839,1047
5397941,241.504,253.087,1287,11680,0.984856,0,2,878126,876839,1287
5416921,214.126,336.523,959,11680,0.9957,0,2,880658,879699,959
5419841,217.36,319.708,997,13140,0.993737,0,2,880898,879901,997
5450501,256.187,251.036,1568,24119,0.989746,0,2,886646,885078,1568
5453421,251.163,317.157,1004,24119,0.986028,0,2,886862,885858,1004
5453421,206.264,108.978,2444,24119,0.992699,0,2,888302,885858,2444
5510361,220.094,313.227,1026,11680,0.99619,0,2,895490,894464,1026
5510361,222.582,274.074,1266,13140,0.992917,0,2,895730,894464,1266
5517661,210.089,112.823,2646,5840,0.99319,0,2,899810,897164,2646
5549781,245.71,289.988,1228,5840,0.981944,0,2,901390,900162,1228
5549781,216.997,253.74,1244,5840,0.969201,0,2,901406,900162,1244
5549781,219.872,222.022,1484,5840,0.966801,0,2,901646,900162,1484
5549781,242.196,148.737,2396,7300,0.976509,0,2,902558,900162,2396
5549781,240.556,113.877,2864,1460,0.977015,0,2,903026,900162,2864
5561461,216.486,358.642,840,5840,0.977388,0,2,903074,902234,840
5562921,232.426,332.062,1038,7300,0.968964,0,2,903418,902380,1038
5565841,227.872,315.304,1036,8760,0.966594,0,2,903614,902578,1036
5565841,205.388,275.891,1084,11680,0.96452,0,2,903662,902578,1084
5565841,200.715,241.405,1252,11680,0.967705,0,2,903830,902578,1252
5565841,198.485,184.826,1636,11680,0.964024,0,2,904214,902578,1636
5567301,224.174,291.972,998,11680,0.967271,0,2,904618,903620,998
5578981,219.322,126.995,2082,8760,0.992158,0,2,907286,905204,2082
5578981,218.906,111.12,2298,10220,0.990638,0,2,907502,905204,2298
5587741,206.915,135.527,2028,11680,0.993824,0,2,908870,906842,2028
5600881,205.24,327.574,1106,8760,0.994728,0,2,910082,908976,1106
5600881,208.085,286.627,1334,10220,0.989137,0,2,910310,908976,1334
5631541,250.257,266.683,1154,16060,0.996996,0,2,915934,914780,1154
5651981,198.439,318.379,1125,11680,0.990845,0,2,918650,917525,1125
5660741,250.612,301.284,1177,18980,0.989641,0,2,920316,919139,1177
5660741,224.285,263.623,1217,20440,0.988436,0,2,920356,919139,1217
5660741,201.052,90.5833,2705,23360,0.992277,0,2,921844,919139,2705
5681181,212.48,96.0558,2911,8760,0.993958,0,2,924868,921957,2911
5681181,200.306,28.8799,4651,21900,0.986933,0,2,926608,921957,4651
5681181,199.775,2.28428,8611,27556,0.995217,0,2,930568,921957,8611
5681181,201.803,1.99874,8827,27556,0.979564,0,2,930784,921957,8827
5681181,202.077,1.7489,9031,27556,0.967119,0,2,930988,921957,9031
5681181,203.818,1.53029,9247,27556,0.964979,0,2,931204,921957,9247
5681181,194.841,1.339,9379,27556,0.965607,0,2,931336,921957,9379
5681181,194.485,1.17163,9571,29016,0.968656,0,2,931528,921957,9571
5681181,195.471,0.180677,12175,14600,0.993916,0,2,934132,921957,12175
5681181,235.836,0.00429662,18631,26049,0.993605,0,2,940588,921957,18631
5681181,236.357,0.00375955,18871,26049,0.990655,0,2,940828,921957,18871
5707461,352.424,2600.75,861,5840,0.99508,0,2,943624,942763,861
5833421,249.087,484.416,972,10220,0.997111,0,2,948415,947443,972
5833421,247.952,423.864,1212,11680,0.993722,0,2,948655,947443,1212
5837801,287.155,413.827,1090,14600,0.992044,0,2,949779,948689,1090
5839261,281.261,392.849,1084,16060,0.974289,0,2,950019,948935,1084
5840721,276.103,374.493,1078,17520,0.975003,0,2,950259,949181,1078
5864081,241.356,126.586,2626,1460,0.991613,0,2,956095,953469,2626
5864081,239.686,110.763,2854,5840,0.991411,0,2,956323,953469,2854
5881601,229.831,279.225,1320,11680,0.991845,0,2,957415,956095,1320
5883061,256.102,320.822,1148,11680,0.991614,0,2,957855,956707,1148
5883061,207.572,125.986,2304,10220,0.990457,0,2,959011,956707,2304
5897661,217.633,107.31,2573,17520,0.997278,0,2,962035,959462,2573
5903501,234.876,373.159,821,20440,0.996666,0,2,962611,961790,821
5923941,236.114,270.255,1085,28815,0.994754,0,2,963939,962854,1085
5925401,186.463,114.655,2005,11680,0.99294,0,2,965011,963006,2005
5925401,188.655,100.323,2209,13140,0.985072,0,2,965215,963006,2209
5925401,190.574,87.7829,2413,14600,0.973188,0,2,965419,963006,2413
5928321,178.752,270.435,960,1460,0.97279,0,2,965515,964555,960
5929781,175.908,257.631,948,5840,0.972441,0,2,965671,964723,948
5940001,158.419,244.427,832,7300,0.969636,0,2,965707,964875,832
5940001,155.117,213.873,964,8760,0.967181,0,2,965839,964875,964
5940001,152.227,187.139,1096,10220,0.967534,0,2,965971,964875,1096
5985261,217.093,245.366,1283,14600,0.995947,0,2,973231,971948,1283
6007161,223.697,118.823,2438,13380,0.993429,0,2,977452,975014,2438
6007161,222.985,103.97,2656,1460,0.981751,0,2,977670,975014,2656
6010081,196.612,310.224,914,5840,0.975282,0,2,977682,976768,914
6011541,200.535,299.946,914,7300,0.970872,0,2,977910,976996,914
6020301,181.03,138.962,1614,13140,0.982491,0,2,979254,977640,1614
6023221,186.901,243.092,870,13140,0.97343,0,2,979482,978612,870
6051201,260.612,256.398,1092,17118,0.993848,0,2,984410,983318,1092
6052661,258.036,255.474,1083,17118,0.984617,0,2,984650,983567,1083
6065801,226.2,137.426,1924,7300,0.996039,0,2,987582,985658,1924
6095001,253.107,260.731,1112,17454,0.983392,0,2,992138,991026,1112
6096461,251.469,258.515,1109,17454,0.976718,0,2,992378,991269,1109
6099381,246.035,256.575,1074,5840,0.975878,0,2,992586,991512,1074
6100841,270.281,285.253,1028,5840,0.967643,0,2,993026,991998,1028
6102301,270.996,279.972,1061,5840,0.962938,0,2,993302,992241,1061
6103761,274.621,288.1,1016,5840,0.946321,0,2,993602,992586,1016
6105221,265.794,282.463,977,17826,0.934281,0,2,993806,992829,977
6106681,267.069,277.53,1010,17682,0.928746,0,2,994082,993072,1010
6108141,260.686,273.214,983,17610,0.923902,0,2,994298,993315,983
6109601,258.1,274.937,936,17502,0.922165,0,2,994538,993602,936
6111061,258.838,270.945,957,17334,0.925644,0,2,994802,993845,957
6150481,213.64,278.793,1032,1460,0.99644,0,2,1000770,999738,1032
6157781,222.074,124.292,2290,7300,0.984283,0,2,1003530,1001240,2290
6168001,224.315,318.505,852,1460,0.974998,0,2,1003770,1002918,852
6176761,212.796,142.663,1888,7300,0.989344,0,2,1006410,1004522,1888
6176761,214.696,124.83,2116,7300,0.979426,0,2,1006638,1004522,2116
6176761,216.359,109.226,2344,7300,0.968247,0,2,1006866,1004522,2344
6185521,213.314,303.073,876,8760,0.960966,0,2,1007058,1006182,876
6185521,212.15,265.189,1080,5840,0.959596,0,2,1007262,1006182,1080
6185521,211.131,232.04,1284,5840,0.953396,0,2,1007466,1006182,1284
6185521,205.74,203.035,1452,5840,0.950472,0,2,1007634,1006182,1452
6185521,202.522,177.656,1632,5840,0.942913,0,2,1007814,1006182,1632
6185521,180.207,155.449,1656,5840,0.938799,0,2,1007838,1006182,1656
6195741,208.681,296.518,780,5840,0.937699,0,2,1008246,1007466,780
6246841,241.067,290.019,2388,18980,0.99616,0,2,1019934,1017546,2388
6246841,236.434,253.766,2592,20440,0.98789,0,2,1020138,1017546,2592
6254141,287.879,518.046,872,21900,0.978154,0,2,1020786,1019914,872
6258521,265.394,471.29,836,23360,0.959635,0,2,1020894,1020058,836
6267281,245.72,430.379,800,24820,0.93843,0,2,1021002,1020202,800
6270201,251.005,394.581,944,26280,0.917377,0,2,1021290,1020346,944
6273121,251.129,381.259,908,26664,0.901455,0,2,1021542,1020634,908
6276041,248.238,369.601,848,26299,0.882523,0,2,1021770,1020922,848
6278961,251.709,359.401,836,25832,0.868457,0,2,1022046,1021210,836
6281881,256.245,350.476,836,25386,0.86615,0,2,1022334,1021498,836
6283341,264.214,342.667,868,25001,0.866631,0,2,1022654,1021786,868
6286261,245.188,317.833,836,24737,0.869552,0,2,1022766,1021930,836
6287721,259.039,314.104,904,24433,0.879608,0,2,1023122,1022218,904
6318381,231.837,243.275,1242,14600,0.986617,0,2,1027424,1026182,1242
6318381,226.331,48.9997,3858,11680,0.992304,0,2,1030040,1026182,3858
6318381,228.04,42.8748,4098,13140,0.984516,0,2,1030280,1026182,4098
6338821,199.231,135.635,3084,11680,0.9911,0,2,1034468,1031384,3084
6351961,201.327,398.056,1065,13140,0.955963,0,2,1034684,1033619,1065
6351961,204.661,348.299,1293,14600,0.916467,0,2,1034912,1033619,1293
6351961,203.078,304.761,1485,16060,0.888159,0,2,1035104,1033619,1485
6351961,189.694,266.666,1581,16060,0.860889,0,2,1035200,1033619,1581
6351961,183.982,233.333,1725,16060,0.834528,0,2,1035344,1033619,1725
6351961,183.484,204.166,1905,17520,0.813962,0,2,1035524,1033619,1905
6351961,169.549,178.645,1977,18980,0.795967,0,2,1035596,1033619,1977
6351961,164.855,156.315,2109,20440,0.777721,0,2,1035728,1033619,2109
6351961,150.248,136.775,2157,21900,0.761756,0,2,1035776,1033619,2157
6351961,147.967,119.679,2289,23360,0.740286,0,2,1035908,1033619,2289
6351961,139.971,104.719,2373,24820,0.729001,0,2,1035992,1033619,2373
6351961,137.475,91.6289,2493,1460,0.719125,0,2,1036112,1033619,2493
6351961,129.29,80.1752,2565,5840,0.717985,0,2,1036184,1033619,2565
6351961,125.129,70.1533,2661,7300,0.714487,0,2,1036280,1033619,2661
6351961,122.988,61.3842,2769,8760,0.718926,0,2,1036388,1033619,2769
6351961,116.615,53.7112,2841,10220,0.72031,0,2,1036460,1033619,2841
6351961,120.038,46.9973,2985,11680,0.729021,0,2,1036604,1033619,2985
6384081,109.533,339.623,633,13140,0.739144,0,2,1036640,1036007,633
6384081,110.841,297.17,753,14600,0.750501,0,2,1036760,1036007,753
6384081,110.486,260.024,861,14600,0.765438,0,2,1036868,1036007,861
6384081,113.175,227.521,993,14600,0.783508,0,2,1037000,1036007,993
6384081,112.528,199.081,1101,14600,0.79932,0,2,1037108,1036007,1101
6384081,111.962,174.195,1209,14600,0.818155,0,2,1037216,1036007,1209
6400141,242.27,19.6134,5382,18980,0.990123,0,2,1043024,1037642,5382
6400141,241.987,17.1618,5622,1460,0.988857,0,2,1043264,1037642,5622
6433721,198.498,367.649,1596,13140,0.99415,0,2,1044860,1043264,1596
6433721,224.442,74.0509,4356,16060,0.993822,0,2,1047620,1043264,4356
6433721,222.068,37.9813,5460,21900,0.989331,0,2,1048724,1043264,5460
6433721,222.81,33.2337,5688,23340,0.969415,0,2,1048952,1043264,5688
6433721,220.458,29.0795,5892,23340,0.955738,0,2,1049156,1043264,5892
6433721,213.901,25.4445,6060,23340,0.955021,0,2,1049324,1043264,6060
6433721,208.163,22.264,6228,23340,0.959393,0,2,1049492,1043264,6228
6433721,200.143,19.481,6372,23340,0.955719,0,2,1049636,1043264,6372
6433721,190.125,17.0459,6492,23340,0.950004,0,2,1049756,1043264,6492
6433721,188.859,14.9151,6672,24800,0.940004,0,2,1049936,1043264,6672
6433721,181.752,13.0507,6804,24800,0.931253,0,2,1050068,1043264,6804
6433721,180.033,11.4194,6972,24920,0.926096,0,2,1050236,1043264,6972
6433721,177.029,9.99196,7128,24920,0.924084,0,2,1050392,1043264,7128
6433721,172.9,8.74297,7272,24920,0.927324,0,2,1050536,1043264,7272
6433721,167.788,7.6501,7404,24920,0.932658,0,2,1050668,1043264,7404
6433721,219.462,0.0625111,14664,29028,0.9982,0,2,1057928,1043264,14664
6433721,222.03,0.0546972,14904,29028,0.993425,0,2,1058168,1043264,14904
6433721,192.034,0.0073805,17568,29028,0.992863,0,2,1060832,1043264,17568
6433721,218.184,0.00378552,18828,31948,0.995089,0,2,1062092,1043264,18828
6433721,219.411,0.00331233,19056,31948,0.973203,0,2,1062320,1043264,19056
6433721,221.985,0.00289829,19296,31948,0.952803,0,2,1062560,1043264,19296
6433721,221.987,0.00253601,19518,29028,0.937452,0,2,1062782,1043264,19518
6500881,584.238,2741.63,705,1460,0.931521,0,2,1065902,1065197,705
6568861,1160.33,1386.85,2688,11680,0.975431,0,2,1092152,1089464,2688
6568861,1045.29,1213.49,2928,1460,0.962252,0,2,1092392,1089464,2928
6592221,298.508,159.063,3628,8760,0.989514,0,2,1096544,1092916,3628
6592221,275.282,71.3869,5176,16060,0.990294,0,2,1098092,1092916,5176
6592221,228.317,28.0333,6568,10220,0.994938,0,2,1099484,1092916,6568
6636021,266.308,250.392,2292,13140,0.995567,0,2,1103732,1101440,2292
6647701,195.876,306.284,948,13140,0.994727,0,2,1105076,1104128,948
6650621,196.892,293.998,944,14600,0.990386,0,2,1105280,1104336,944
6652081,184.28,276.749,884,16060,0.987838,0,2,1105376,1104492,884
6659381,188.245,261.655,944,17520,0.980608,0,2,1105592,1104648,944
6662301,197.714,248.448,1052,18980,0.971782,0,2,1105856,1104804,1052
6665221,203,256.392,980,21900,0.966559,0,2,1106096,1105116,980
6690041,224.672,82.4345,2984,10220,0.985211,0,2,1112096,1109112,2984
6690041,265.729,21.6865,5888,10220,0.987359,0,2,1115000,1109112,5888
6690041,278.239,11.1232,7376,17520,0.979767,0,2,1116488,1109112,7376
6690041,252.84,4.99204,8756,5840,0.984669,0,2,1117868,1109112,8756
6690041,249.735,4.36804,8984,5840,0.965336,0,2,1118096,1109112,8984
6744061,445.612,959.987,1020,18023,0.97343,0,2,1121344,1120324,1020
6764501,267.291,335.785,1130,20533,0.994653,0,2,1124650,1123520,1130
6774721,269.827,302.355,1146,25257,0.994757,0,2,1125982,1124836,1146
6776181,215.205,98.9801,2618,1460,0.997174,0,2,1127642,1125024,2618
6792241,215.373,328.592,1053,13140,0.989982,0,2,1128974,1127921,1053
6809761,213.4,283.231,1539,11680,0.984705,0,2,1131890,1130351,1539
6809761,216.725,247.827,1779,13140,0.982867,0,2,1132130,1130351,1779
6809761,219.634,216.849,2019,5840,0.976259,0,2,1132370,1130351,2019
6809761,220.68,189.742,2247,5840,0.970476,0,2,1132598,1130351,2247
6809761,211.095,166.025,2391,5840,0.965417,0,2,1132742,1130351,2391
6809761,204.208,145.272,2547,1460,0.95099,0,2,1132898,1130351,2547
6815601,265.682,431.613,807,5840,0.945866,0,2,1133594,1132787,807
6824361,250.472,397.786,790,24820,0.946383,0,2,1133738,1132948,790
6853561,231.137,109.08,2499,1460,0.986753,0,2,1139114,1136615,2499
6887141,195.434,233.452,1238,13140,0.997948,0,2,1143494,1142256,1238
6901741,180.24,78.5645,2915,5840,0.992391,0,2,1147780,1144865,2915
6901741,184.71,68.7439,3131,5840,0.984592,0,2,1147996,1144865,3131
6901741,185.622,60.1509,3323,5840,0.985268,0,2,1148188,1144865,3323
6939701,243.432,324.137,1026,11680,0.994918,0,2,1154368,1153342,1026
6939701,243.003,283.62,1266,13140,0.993053,0,2,1154608,1153342,1266
6939701,243.539,57.1259,4230,13140,0.996101,0,2,1157572,1153342,4230
6939701,241.568,25.6378,5670,8760,0.9845,0,2,1159012,1153342,5670
6939701,230.367,10.0679,7230,17520,0.991413,0,2,1160572,1153342,7230
6939701,215.947,3.95361,8670,5840,0.994128,0,2,1162012,1153342,8670
6939701,217.453,3.45941,8898,5840,0.991112,0,2,1162240,1153342,8898
6995181,387.516,1008.01,1058,22087,0.99229,0,2,1164828,1163770,1058
7008321,247.62,484.187,1006,10220,0.996141,0,2,1167520,1166514,1006
7015621,246.667,452.414,1016,11680,0.994124,0,2,1167760,1166744,1016
7024381,253.923,179.262,2305,7300,0.997397,0,2,1170736,1168431,2305
7037521,235.159,225.018,1594,10220,0.996478,0,2,1172332,1170738,1594
7037521,251.647,115.414,2950,7300,0.980694,0,2,1173688,1170738,2950
7037521,248.691,100.987,3178,8760,0.971857,0,2,1173916,1170738,3178
7037521,244.605,88.3636,3394,10220,0.974125,0,2,1174132,1170738,3394
7037521,248.529,77.3182,3670,10220,0.973609,0,2,1174408,1170738,3670
7060881,227.622,499.327,1058,13140,0.992849,0,2,1177432,1176374,1058
7066721,274.078,429.853,1086,5840,0.992058,0,2,1178832,1177746,1086
7068181,265.318,404.622,1062,5840,0.990551,0,2,1179036,1177974,1062
7075481,268.223,335.243,1104,18761,0.988903,0,2,1180392,1179288,1104
7076941,264.695,321.838,1116,18761,0.989041,0,2,1180632,1179516,1116
7087161,252.982,160.38,2092,7300,0.994977,0,2,1183360,1181268,2092
7103221,231.996,266.268,1147,13140,0.994524,0,2,1185112,1183965,1147
7107601,257.589,280.003,1133,16060,0.98554,0,2,1186296,1185163,1133
7109061,255.391,271.253,1163,17520,0.969848,0,2,1186536,1185373,1163
7110521,253.467,263.596,1193,18980,0.971117,0,2,1186776,1185583,1193
7110521,223.784,230.647,1209,19772,0.970977,0,2,1186792,1185583,1209
7126581,217.955,237.938,1188,11680,0.985819,0,2,1189300,1188112,1188
7130961,249.562,273.47,1100,14600,0.975227,0,2,1190700,1189600,1100
7133881,247.366,265.536,1122,16060,0.959573,0,2,1190932,1189810,1122
7147021,247.408,136.484,2426,1460,0.989574,0,2,1195276,1192850,2426
7173301,249.5,161.64,2062,5840,0.991423,0,2,1199644,1197582,2062
7186441,244.983,274.337,1224,10220,0.991151,0,2,1201108,1199884,1224
7186441,242.861,240.044,1452,10220,0.984757,0,2,1201336,1199884,1452
7202501,284.701,299.012,1057,21325,0.974167,0,2,1204056,1202999,1057
7203961,276.113,290.261,1044,21325,0.952396,0,2,1204272,1203228,1044
7206881,267.599,276.853,1069,21325,0.945847,0,2,1204480,1203411,1069
7209801,270.149,287.996,991,21325,0.948866,0,2,1204768,1203777,991
7221481,249.026,133.036,2297,11680,0.984479,0,2,1207642,1205345,2297
7221481,250.898,116.406,2561,1460,0.985169,0,2,1207906,1205345,2561
7231701,244.337,57.6916,4385,13140,0.997409,0,2,1212177,1207792,4385
7262361,263.285,175.328,3022,18744,0.9984,0,2,1216382,1213360,3022
7272581,246.449,225.672,2249,17600,0.994372,0,2,1218055,1215806,2249
7291561,250.015,310.513,1236,14600,0.997058,0,2,1220383,1219147,1236
7307621,317.235,702.536,991,8760,0.998403,0,2,1225465,1224474,991
7316381,310.759,554.305,1126,11680,0.99143,0,2,1226326,1225200,1126
7317841,306.414,515.267,1160,13140,0.986251,0,2,1226602,1225442,1160
7336821,315.178,229.603,2633,1460,0.991548,0,2,1232603,1229970,2633
7336821,314.78,200.903,2945,5840,0.977605,0,2,1232915,1229970,2945
7347041,299.335,395.93,1161,10220,0.983513,0,2,1234260,1233099,1161
7348501,280.407,169.168,2733,1460,0.984776,0,2,1236076,1233343,2733
7348501,273.187,129.52,3237,7300,0.987094,0,2,1236580,1233343,3237
7393761,294.362,232.305,1661,17711,0.998349,0,2,1244626,1242965,1661
7417121,291.807,348.224,1440,10220,0.992329,0,2,1249567,1248127,1440
7417121,294.331,304.696,1752,10220,0.987038,0,2,1249879,1248127,1752
7433181,292.578,351.708,1080,16649,0.996466,0,2,1253659,1252579,1080
7453621,274.631,293.686,1010,16567,0.995627,0,2,1257355,1256345,1010
7476981,236.517,304.893,922,10220,0.997048,0,2,1261511,1260589,922
7476981,238.453,266.781,1174,11680,0.993667,0,2,1261763,1260589,1174
7484281,249.858,151.329,2206,7300,0.994584,0,2,1264411,1262205,2206
7484281,245.626,132.413,2422,1460,0.986511,0,2,1264627,1262205,2422
7484281,243.422,115.861,2650,5840,0.985697,0,2,1264855,1262205,2650
7498881,233.337,330.525,1113,11680,0.990366,0,2,1265719,1264606,1113
7498881,231.17,289.209,1329,11680,0.98907,0,2,1265935,1264606,1329
7506181,243.28,317.388,977,16060,0.991428,0,2,1266751,1265774,977
7523701,208.057,294.185,1068,13140,0.995093,0,2,1270123,1269055,1068
7538301,205.037,348.304,1168,13140,0.986743,0,2,1272971,1271803,1168
7602541,151.32,234.831,984,5840,0.981167,0,2,1278947,1277963,984
7604001,160.905,254.977,816,5840,0.978521,0,2,1279175,1278359,816
7617141,167.404,52.2984,2652,1460,0.994964,0,2,1281983,1279331,2652
7698901,216.236,697.176,1116,13140,0.996247,0,2,1293863,1292747,1116
7698901,209.652,312.889,2316,20440,0.993316,0,2,1295063,1292747,2316
7698901,211.945,273.778,2544,21900,0.976651,0,2,1295291,1292747,2544
7698901,213.952,239.556,2772,1460,0.97707,0,2,1295519,1292747,2772
7728101,216.495,171.913,2240,7300,0.987881,0,2,1298123,1295883,2240
7728101,217.933,150.424,2468,1460,0.980646,0,2,1298351,1295883,2468
7744161,243.087,293.457,1120,11680,0.99115,0,2,1300063,1298943,1120
7758761,212.673,115.848,2254,10220,0.99344,0,2,1302899,1300645,2254
7779201,200.093,300.477,920,13140,0.995246,0,2,1304447,1303527,920
7787961,250.28,288.852,1122,21900,0.995963,0,2,1305727,1304605,1122
7789421,247.495,271.996,1196,23360,0.995218,0,2,1305955,1304759,1196
7789421,220.058,237.996,1224,24820,0.993316,0,2,1305983,1304759,1224
7792341,226.015,316.812,936,1460,0.99575,0,2,1307375,1306439,936
7802561,215.61,238.786,1214,11680,0.990831,0,2,1308839,1307625,1214
7823001,302.945,174.203,2510,1460,0.992667,0,2,1312967,1310457,2510
7825921,323.577,435.428,714,20440,0.989834,0,2,1313435,1312721,714
7843441,219.73,98.6293,2744,5840,0.988628,0,2,1316855,1314111,2744
7863881,207.285,114.115,2406,8760,0.994496,0,2,1319555,1317149,2406
7863881,215.53,51.2141,3738,11680,0.99253,0,2,1320887,1317149,3738
7893081,239.458,606.805,1093,11680,0.99453,0,2,1323659,1322566,1093
7901841,335.565,509.745,864,1460,0.974371,0,2,1326551,1325687,864
7901841,382.119,446.027,1572,17520,0.941324,0,2,1327259,1325687,1572
7903301,350.854,514.023,714,17520,0.909909,0,2,1327391,1326677,714
7907681,321.998,469.271,678,18980,0.88992,0,2,1327511,1326833,678
7910601,316.248,430.112,798,20440,0.88993,0,2,1327787,1326989,798
7941261,193.822,270.412,1035,13140,0.989168,0,2,1332343,1331308,1035
7941261,199.594,236.61,1275,14600,0.984272,0,2,1332583,1331308,1275
7941261,222.932,6.4306,7055,13140,0.997073,0,2,1338363,1331308,7055
7941261,225.066,5.62677,7295,13140,0.991188,0,2,1338603,1331308,7295
8006961,194.876,56.0487,4020,16060,0.993668,0,2,1350063,1346043,4020
8006961,200.517,49.0426,4260,17520,0.991959,0,2,1350303,1346043,4260
8049301,201.492,441.695,1302,16060,0.99751,0,2,1353171,1351869,1302
8049301,188.88,258.913,2022,21900,0.99479,0,2,1353891,1351869,2022
8049301,187.77,226.549,2202,23360,0.979192,0,2,1354071,1351869,2202
8049301,192.799,198.23,2430,24820,0.950543,0,2,1354299,1351869,2430
8049301,194.199,173.452,2634,1460,0.922975,0,2,1354503,1351869,2634
8049301,186.424,151.77,2766,5840,0.898853,0,2,1354635,1351869,2766
8049301,166.121,132.799,2790,7300,0.875246,0,2,1354659,1351869,2790
8049301,152.856,116.199,2850,8760,0.857091,0,2,1354719,1351869,2850
8049301,144.249,101.674,2934,10220,0.846204,0,2,1354803,1351869,2934
8049301,136.718,88.9649,3018,11680,0.834179,0,2,1354887,1351869,3018
8049301,131.628,77.8443,3114,13140,0.826156,0,2,1354983,1351869,3114
8049301,121.175,68.1138,3162,14600,0.811637,0,2,1355031,1351869,3162
8055141,122.528,385.475,687,16060,0.801432,0,2,1355163,1354476,687
8056601,117.712,350.415,666,17520,0.800003,0,2,1355247,1354581,666
8072661,117.998,319.738,681,18980,0.806253,0,2,1355367,1354686,681
8072661,116.748,279.771,789,20440,0.816721,0,2,1355475,1354686,789
8079961,117.155,271.05,699,20440,0.830881,0,2,1355595,1354896,699
8079961,113.01,237.168,783,21900,0.840771,0,2,1355679,1354896,783
8082881,125.884,233.772,789,21900,0.856925,0,2,1355895,1355106,789
8100401,190.445,58.4977,2699,1460,0.974444,0,2,1358787,1356088,2699
8112081,226.828,46.4275,4184,14600,0.996146,0,2,1363095,1358911,4184
8112081,252.214,23.8131,5600,1460,0.994273,0,2,1364511,1358911,5600
8154421,215.922,25.8665,5897,5840,0.997381,0,2,1370487,1364590,5897
8208441,222.979,298.904,1252,11680,0.992361,0,2,1375059,1373807,1252
8208441,248.401,134.147,2908,5840,0.989072,0,2,1376715,1373807,2908
8230341,240.708,65.4288,3976,10220,0.990386,0,2,1381131,1377155,3976
8230341,239.119,57.2502,4204,10220,0.990337,0,2,1381359,1377155,4204
8230341,234.729,50.0939,4408,10220,0.987795,0,2,1381563,1377155,4408
8252241,459.5,802.309,742,1460,0.978074,0,2,1384047,1383305,742
8277061,250.632,267.763,1368,11680,0.986485,0,2,1388691,1387323,1368
8293121,242.599,302.135,1153,14600,0.996368,0,2,1391759,1390606,1153
8317941,203.747,243.677,1112,5840,0.992249,0,2,1395675,1394563,1112
8317941,208.279,213.217,1352,5840,0.964468,0,2,1395915,1394563,1352
8317941,212.244,186.565,1592,5840,0.940159,0,2,1396155,1394563,1592
8317941,209.714,163.244,1784,5840,0.916389,0,2,1396347,1394563,1784
8317941,195.499,142.839,1880,21900,0.898091,0,2,1396443,1394563,1880
8317941,187.562,124.984,2012,23360,0.874579,0,2,1396575,1394563,2012
8317941,222.617,109.361,2480,1460,0.864007,0,2,1397043,1394563,2480
8317941,211.29,95.6908,2612,5840,0.857256,0,2,1397175,1394563,2612
8317941,205.878,83.7294,2780,7300,0.848849,0,2,1397343,1394563,2780
8317941,201.144,73.2632,2948,8760,0.851493,0,2,1397511,1394563,2948
8334001,186.501,355.98,697,10220,0.858806,0,2,1397595,1396898,697
8334001,182.688,311.483,853,11680,0.865205,0,2,1397751,1396898,853
8334001,182.352,272.547,1033,11680,0.878305,0,2,1397931,1396898,1033
8345681,221.366,131.962,2231,8760,0.963237,0,2,1400679,1398448,2231
8345681,223.696,115.466,2471,10220,0.962832,0,2,1400919,1398448,2471
8358821,224.421,357.88,924,10220,0.979686,0,2,1402071,1401147,924
8364661,226.369,338.895,958,11680,0.969725,0,2,1402311,1401353,958
8374881,221.424,116.318,2487,10220,0.985152,0,2,1405131,1402644,2487
8377801,223.746,313.653,1032,1460,0.983258,0,2,1405371,1404339,1032
8393861,220.315,94.8684,2736,5840,0.994918,0,2,1408419,1405683,2736
8393861,222.116,72.6336,3192,8760,0.987359,0,2,1408875,1405683,3192
8393861,216.852,63.5544,3372,10220,0.982689,0,2,1409055,1405683,3372
8393861,209.245,55.6101,3528,10220,0.976103,0,2,1409211,1405683,3528
8393861,190.59,48.6588,3588,11680,0.96534,0,2,1409271,1405683,3588
8393861,186.266,42.5765,3744,11680,0.953423,0,2,1409427,1405683,3744
8393861,176.483,37.2544,3852,13140,0.945495,0,2,1409535,1405683,3852
8393861,175.422,32.5976,4020,14600,0.932308,0,2,1409703,1405683,4020
8393861,190.995,28.5229,4320,16060,0.93077,0,2,1410003,1405683,4320
8393861,189.62,24.9576,4500,17520,0.928173,0,2,1410183,1405683,4500
8393861,182.418,21.8379,4632,18980,0.928402,0,2,1410315,1405683,4632
8393861,170.99,19.1081,4723,20440,0.931101,0,2,1410406,1405683,4723
8393861,169.117,16.7196,4879,21900,0.930964,0,2,1410562,1405683,4879
8393861,164.477,14.6297,5011,1460,0.930843,0,2,1410694,1405683,5011
8393861,161.917,12.801,5155,5840,0.930738,0,2,1410838,1405683,5155
8393861,156.678,11.2008,5275,7300,0.930646,0,2,1410958,1405683,5275
8393861,158.093,9.80073,5443,8760,0.933065,0,2,1411126,1405683,5443
8393861,151.831,8.57564,5551,10220,0.937682,0,2,1411234,1405683,5551
8393861,150.852,7.50368,5695,11680,0.944222,0,2,1411378,1405683,5695
8430361,137.996,627.941,772,13140,0.949944,0,2,1411426,1410654,772
8452261,220.844,174.833,2379,17520,0.996802,0,2,1418518,1416139,2379
8452261,223.239,152.979,2619,1460,0.989702,0,2,1418758,1416139,2619
8485841,204.723,205.419,1536,13140,0.993204,0,2,1422946,1421410,1536
8485841,209.133,179.742,1776,14600,0.990304,0,2,1423186,1421410,1776
8485841,219.937,92.1912,2904,7300,0.992527,0,2,1424314,1421410,2904
8485841,220.945,80.6673,3132,8760,0.978461,0,2,1424542,1421410,3132
8497521,221.827,352.209,1107,10220,0.978653,0,2,1424770,1423663,1107
8497521,181.833,105.894,2463,1460,0.989832,0,2,1426126,1423663,2463
8529641,170.003,110.428,2028,16060,0.985331,0,2,1428886,1426858,2028
8529641,177.253,96.6245,2256,14600,0.985915,0,2,1429114,1426858,2256
8548621,229.595,53.2402,4286,13140,0.992328,0,2,1436098,1431812,4286
8570521,240.214,563.394,938,11680,0.995307,0,2,1437670,1436732,938
8570521,245.099,221.242,2438,1460,0.975657,0,2,1439170,1436732,2438
8599721,287.962,469.587,818,16060,0.97495,0,2,1439758,1438940,818
8643521,223.827,175.713,1800,10220,0.998483,0,2,1447810,1446010,1800
8643521,225.849,153.749,2040,11680,0.996172,0,2,1448050,1446010,2040
8659581,238.747,293.484,1039,10220,0.997032,0,2,1449550,1448511,1039
8666881,205.007,106.133,2327,10220,0.993227,0,2,1452406,1450079,2327
8681481,206.931,305.271,1208,5840,0.990173,0,2,1454074,1452866,1208
8681481,208.064,267.112,1424,5840,0.985151,0,2,1454290,1452866,1424
8681481,231.556,233.723,1820,5840,0.985757,0,2,1454686,1452866,1820
8719441,238.221,172.295,2636,1460,0.996161,0,2,1464303,1461667,2636
8742801,259.874,342.665,1148,11680,0.995992,0,2,1466135,1464987,1148
8763241,195.309,331.428,982,13140,0.998209,0,2,1468851,1467869,982
8763241,196.395,290,1186,14600,0.995933,0,2,1469055,1467869,1186
8780761,208.983,294.616,1044,21900,0.995533,0,2,1471527,1470483,1044
8780761,212.86,257.789,1284,21900,0.993592,0,2,1471767,1470483,1284
8798281,226.836,259.642,1248,13140,0.992459,0,2,1474431,1473183,1248
8817261,197.572,276.341,1026,16060,0.993837,0,2,1477203,1476177,1026
8817261,201.375,241.798,1254,17520,0.993357,0,2,1477431,1476177,1254
8824561,210.711,254.247,1502,14600,0.996476,0,2,1480251,1478749,1502
8824561,209.811,87.3614,3194,8760,0.993789,0,2,1481943,1478749,3194
8845001,213.493,171.638,2234,16060,0.993811,0,2,1483431,1481197,2234
8862521,195.211,318.851,1346,14600,0.991623,0,2,1484919,1483573,1346
8887341,217.652,107.378,2784,1460,0.99567,0,2,1489491,1486707,2784
8904861,194.547,307.888,1008,14600,0.98955,0,2,1490763,1489755,1008
8904861,200.228,269.402,1248,16060,0.984606,0,2,1491003,1489755,1248
8931141,189.665,90.8027,2510,10220,0.994286,0,2,1495412,1492902,2510
8954501,214.334,66.3824,3469,10220,0.997105,0,2,1499696,1496227,3469
8954501,216.043,58.0846,3697,11680,0.987467,0,2,1499924,1496227,3697
8954501,221.781,22.8096,5245,20440,0.987578,0,2,1501472,1496227,5245
8992461,218.891,247.608,2399,5840,0.991561,0,2,1504232,1501833,2399
8992461,221.53,216.657,2639,1460,0.981366,0,2,1504472,1501833,2639
9055241,225.224,137.894,2345,8760,0.998723,0,2,1516100,1513755,2345
9072761,233.01,336.277,1030,11680,0.998177,0,2,1517564,1516534,1030
9080061,262.463,314.864,1110,18980,0.995181,0,2,1518808,1517698,1110
9081521,259.655,299.756,1156,20440,0.985784,0,2,1519048,1517892,1156
9100501,228.025,163.99,2190,7300,0.984139,0,2,1523564,1521374,2190
9100501,229.522,143.491,2430,7300,0.974872,0,2,1523804,1521374,2430
9109261,226.332,339.305,924,1460,0.966763,0,2,1524008,1523084,924
9109261,220.54,296.891,1104,5840,0.949667,0,2,1524188,1523084,1104
9109261,218.473,259.78,1308,7300,0.937209,0,2,1524392,1523084,1308
9109261,215.164,227.308,1500,8760,0.926308,0,2,1524584,1523084,1500
9109261,198.768,198.894,1584,10220,0.921769,0,2,1524668,1523084,1584
9116561,197.922,301.157,759,10220,0.907798,0,2,1524860,1524101,759
9116561,200.182,263.513,975,11680,0.900573,0,2,1525076,1524101,975
9128241,242.294,9.89727,6762,13140,0.989666,0,2,1532612,1525850,6762
9128241,242.007,8.66011,7002,13140,0.987208,0,2,1532852,1525850,7002
9128241,257.012,1.16854,11142,19849,0.993274,0,2,1536992,1525850,11142
9128241,254.885,1.02247,11382,21309,0.972865,0,2,1537232,1525850,11382
9198321,247.725,570.394,1103,24819,0.987504,0,2,1539844,1538741,1103
9199781,244.259,519.095,1163,24819,0.984066,0,2,1540064,1538901,1163
9199781,242.227,454.208,1391,24819,0.984807,0,2,1540292,1538901,1391
9239201,236.935,88.3162,3391,5840,0.993686,0,2,1549436,1546045,3391
9239201,237.318,77.2767,3631,5840,0.993226,0,2,1549676,1546045,3631
9266941,267.335,176.338,2490,11680,0.997705,0,2,1555196,1552706,2490
9287381,221.171,331.269,1108,13140,0.992849,0,2,1556528,1555420,1108
9304901,206.292,105.018,2450,11680,0.990871,0,2,1560891,1558441,2450
9323881,209.642,329.771,1276,13140,0.991415,0,2,1562355,1561079,1276
9329721,239.497,310.879,1139,5840,0.984347,0,2,1563726,1562587,1139
9331181,238.06,296.519,1171,5840,0.976303,0,2,1563954,1562783,1171
9331181,209.678,259.454,1182,5840,0.970515,0,2,1563965,1562783,1182
9331181,255.468,227.022,1758,5840,0.967951,0,2,1564541,1562783,1758
9331181,253.534,198.645,1998,18980,0.964457,0,2,1564781,1562783,1998
9331181,244.343,173.814,2178,5840,0.9614,0,2,1564961,1562783,2178
9331181,261.8,152.087,2562,1460,0.952475,0,2,1565345,1562783,2562
9331181,255.325,133.076,2772,5840,0.942166,0,2,1565555,1562783,2772
9341401,226.409,366.192,798,7300,0.930645,0,2,1565579,1564781,798
9342861,245.608,342.918,998,8760,0.910564,0,2,1565959,1564961,998
9342861,228.907,300.053,1110,10220,0.897994,0,2,1566071,1564961,1110
9342861,219.794,262.546,1266,10220,0.886995,0,2,1566227,1564961,1266
9342861,222.319,229.728,1506,10220,0.87737,0,2,1566467,1564961,1506
9344321,243.53,326.137,897,10220,0.856449,0,2,1566859,1565962,897
9345781,243.088,313.87,909,11680,0.840643,0,2,1567099,1566190,909
9347241,238.202,303.136,885,13140,0.824313,0,2,1567303,1566418,885
9348701,239.927,293.744,909,14600,0.815023,0,2,1567555,1566646,909
9350161,235.436,285.526,885,16060,0.804395,0,2,1567759,1566874,885
9353081,229.007,278.335,841,17520,0.791346,0,2,1567943,1567102,841
9356001,248.381,289.043,861,20426,0.766178,0,2,1568327,1567466,861
9358921,258.208,298.413,824,20234,0.734156,0,2,1568654,1567830,824
9361841,263.432,306.611,760,20044,0.694886,0,2,1568954,1568194,760
9364761,271.503,313.785,724,19749,0.641775,0,1,1569282,1568558,724
9367681,270.94,320.062,627,19428,0.590303,0,1,1569549,1568922,627
9370601,274.573,325.554,563,19188,0.545265,0,1,1569849,1569286,563
9373521,282.251,330.36,535,18692,0.513357,0,1,1570185,1569650,535
9374981,294.47,333.815,557,18222,0.505438,0,2,1570565,1570008,557
9376441,286.161,314.463,606,17844,0.518508,0,2,1570793,1570187,606
9377901,277.391,297.53,643,17596,0.544944,0,2,1571009,1570366,643
9379361,272.717,282.714,704,17439,0.590576,0,2,1571249,1570545,704
9397261,265.971,241.796,1127,17400,0.890754,0,2,1574084,1572957,1127
9398721,261.225,233.947,1176,17457,0.89691,0,2,1574312,1573136,1176
9398721,236.685,104.994,2416,10220,0.949984,0,2,1575552,1573136,2416
9401641,253.39,156.627,2316,14537,0.973803,0,2,1577160,1574844,2316
9419161,255.812,412.46,955,8760,0.981563,0,2,1578456,1577501,955
9419161,237.407,83.0766,3811,11680,0.983787,0,2,1581312,1577501,3811
9419161,232.263,55.6548,4483,5840,0.980388,0,2,1581984,1577501,4483
9441061,461.23,813.448,429,14537,0.91659,0,2,1584048,1583619,429
9442521,473.576,751.142,674,15997,0.880766,0,2,1584608,1583934,674
9443981,462.379,696.624,743,16430,0.86942,0,2,1584992,1584249,743
9445441,442.082,641.046,791,16207,0.869493,0,2,1585292,1584501,791
9446901,427.322,592.415,863,16068,0.884556,0,2,1585616,1584753,863
9471721,266.835,268.427,1139,18203,0.985574,0,2,1589972,1588833,1139
9484861,256.688,328.631,944,8760,0.984594,0,2,1592832,1591888,944
9502381,301.219,358.75,1142,5840,0.943954,0,2,1596140,1594998,1142
9503841,292.067,344.531,1125,5840,0.89721,0,2,1596368,1595243,1125
9503841,259.059,301.465,1153,5840,0.861308,0,2,1596396,1595243,1153
9503841,282.176,263.782,1597,17027,0.804895,0,2,1596840,1595243,1597
9503841,263.404,230.809,1729,17422,0.753033,0,2,1596972,1595243,1729
9503841,251.479,201.958,1897,4380,0.700154,0,2,1597140,1595243,1897
9503841,244.044,176.713,2089,5840,0.656385,0,2,1597332,1595243,2089
9512601,227.038,370.749,468,7300,0.633087,0,2,1597440,1596972,468
9514061,240.159,345.405,632,20396,0.615201,0,2,1597772,1597140,632
9515521,241.639,332.855,639,21856,0.614551,0,2,1598024,1597385,639
9516981,251.934,321.873,718,22104,0.631482,0,2,1598348,1597630,718
9518441,247.442,306.639,734,21651,0.666297,0,2,1598564,1597830,734
9530121,216.595,107.909,2158,8760,0.934938,0,2,1601268,1599110,2158
9530121,219.52,94.4204,2398,8760,0.918071,0,2,1601508,1599110,2398
9530121,222.08,82.6179,2638,8760,0.924562,0,2,1601748,1599110,2638
9550561,241.763,189.342,1906,7300,0.981385,0,2,1604652,1602746,1906
9566621,251.149,183.043,2024,10220,0.994219,0,2,1607916,1605892,2024
9588521,296.08,419.766,836,5840,0.979729,0,2,1610652,1609816,836
9591441,280.07,393.92,791,18915,0.961013,0,2,1610820,1610029,791
9592901,294.061,371.305,970,18915,0.952136,0,2,1611212,1610242,970
9594361,285.804,351.517,985,18833,0.948119,0,2,1611440,1610455,985
9597281,271.578,334.202,944,18792,0.942105,0,2,1611612,1610668,944
9601661,286.427,329.093,991,18553,0.954424,0,2,1612298,1611307,991
9611881,234.152,119.181,2329,10220,0.990718,0,2,1615310,1612981,2329
9627941,234.702,304.558,1149,11680,0.992084,0,2,1616726,1615577,1149
9636701,225.869,111.474,2573,11680,0.992156,0,2,1619558,1616985,2573
9651301,226.409,322.031,1140,11680,0.99398,0,2,1620938,1619798,1140
9651301,214.552,126.46,2604,5840,0.985136,0,2,1622402,1619798,2604
9651301,217.733,110.653,2844,5840,0.974494,0,2,1622642,1619798,2844
9657141,226.517,382.321,848,5840,0.973932,0,2,1622930,1622082,848
9667361,214.702,354.531,820,5840,0.963441,0,2,1623062,1622242,820
9667361,205.864,310.215,964,5840,0.96176,0,2,1623206,1622242,964
9670281,199.631,311.438,800,5840,0.95279,0,2,1623362,1622562,800
9673201,236.177,318.508,924,20440,0.939942,0,2,1623854,1622930,924
9676121,247.155,318.695,928,23360,0.936199,0,2,1624178,1623250,928
9679041,253.761,318.858,908,24107,0.930424,0,2,1624478,1623570,908
9681961,264.041,319.001,924,23815,0.935371,0,2,1624814,1623890,924
9698021,213.339,160.343,2040,10220,0.993638,0,2,1629026,1626986,2040
9708241,215.172,300.425,987,11680,0.991933,0,2,1629254,1628267,987
9728681,209.629,144.564,2269,20440,0.996862,0,2,1633274,1631005,2269
9728681,211.926,126.493,2497,1460,0.989754,0,2,1633502,1631005,2497
9750581,209.035,154.125,2024,5840,0.993194,0,2,1636166,1634142,2024
9750581,227.906,134.859,2384,5840,0.949045,0,2,1636526,1634142,2384
9752041,209.918,317.002,876,5840,0.915414,0,2,1636610,1635734,876
9759341,264.678,386.876,648,5840,0.854738,0,2,1637258,1636610,648
9759341,293.093,338.517,1140,5840,0.789145,0,2,1637750,1636610,1140
9762261,340.457,473.952,390,18980,0.726752,0,1,1638422,1638032,390
9763721,305.399,424.833,369,20440,0.669658,0,1,1638482,1638113,369
9765181,277.725,381.854,372,21900,0.627201,0,2,1638566,1638194,372
9766641,256.509,344.247,399,23360,0.595051,0,2,1638674,1638275,399
9768101,233.445,311.341,390,24820,0.576919,0,2,1638746,1638356,390
9772481,214.765,282.549,393,26280,0.563555,0,2,1638830,1638437,393
9775401,214.919,257.355,528,27740,0.57436,0,2,1639046,1638518,528
9778321,218.054,245.436,606,30660,0.618815,0,2,1639286,1638680,606
9791461,228.497,91.911,2400,18980,0.894755,0,2,1641890,1639490,2400
9791461,228.435,80.4221,2628,16060,0.89166,0,2,1642118,1639490,2628
9801681,254.266,323.107,1285,8760,0.950128,0,2,1643774,1642489,1285
9825041,223.352,266.558,1379,13140,0.98996,0,2,1646678,1645299,1379
9848401,237.579,285.942,1091,5840,0.985065,0,2,1650250,1649159,1091
9849861,234.882,279.949,1069,5840,0.945682,0,2,1650466,1649397,1069
9851321,238.522,274.706,1095,5840,0.887471,0,2,1650730,1649635,1095
9852781,240.206,270.117,1109,5840,0.815287,0,2,1650982,1649873,1109
9855701,227.181,283.478,868,5840,0.749627,0,1,1651118,1650250,868
9858621,234.783,308.043,676,18980,0.672173,0,1,1651406,1650730,676
9861541,244.435,330.788,498,19543,0.591902,0,1,1651718,1651220,498
9864461,253.256,336.939,433,18856,0.519164,0,1,1652033,1651600,433
9867381,270.849,342.322,447,18145,0.458018,0,1,1652427,1651980,447
9870301,282.618,347.032,432,17543,0.412016,0,1,1652792,1652360,432
9871761,297.165,351.153,451,16991,0.374264,0,1,1653191,1652740,451
9873221,287.02,331.009,477,16537,0.343731,0,1,1653407,1652930,477
9874681,276.642,313.382,491,16182,0.317015,0,1,1653611,1653120,491
9877601,263.562,297.96,473,15899,0.306138,0,1,1653783,1653310,473
9879061,281.117,308.215,497,17331,0.314121,0,2,1654187,1653690,497
9880521,275.977,293.438,547,17080,0.328606,0,2,1654427,1653880,547
9881981,266.98,276.383,594,16961,0.34378,0,2,1654631,1654037,594
9883441,260.608,261.46,653,16932,0.369557,0,2,1654847,1654194,653
9886361,248.032,248.403,656,16932,0.404613,0,2,1655007,1654351,656
9889281,262.028,256.602,702,16932,0.457786,0,2,1655367,1654665,702
9899501,232.718,99.9034,2335,10220,0.879539,0,2,1658235,1655900,2335
9899501,232.128,87.4155,2563,11680,0.869596,0,2,1658463,1655900,2563
9899501,231.612,76.4886,2791,13140,0.875897,0,2,1658691,1655900,2791
9921401,228.918,144.626,2509,7300,0.975862,0,2,1661859,1659350,2509
9931621,226.581,156.483,2294,14600,0.986771,0,2,1663421,1661127,2294
9931621,222.414,119.807,2714,17410,0.988622,0,2,1663841,1661127,2714
9931621,217.112,104.831,2894,1460,0.988794,0,2,1664021,1661127,2894
9931621,203.148,80.2614,3211,7300,0.99017,0,2,1664338,1661127,3211
9931621,204.082,61.4502,3624,10220,0.991224,0,2,1664751,1661127,3624
9931621,204.697,53.7689,3833,5840,0.976071,0,2,1664960,1661127,3833
9931621,205.36,47.0478,4043,5840,0.942812,0,2,1665170,1661127,4043
9931621,205.19,41.1668,4247,5840,0.903711,0,2,1665374,1661127,4247
9943301,523.041,875.646,278,1460,0.799497,0,1,1668122,1667844,278
9954981,492.911,800.94,282,15950,0.71081,0,1,1668404,1668122,282
9956441,483.297,728.448,477,16009,0.645709,0,1,1668820,1668343,477
9957901,452.885,665.017,496,15415,0.591245,0,1,1669060,1668564,496
9959361,426.274,609.515,515,14927,0.551089,0,1,1669300,1668785,515
9960821,407.49,560.95,570,14531,0.540953,0,2,1669576,1669006,570
9962281,385.054,518.457,577,14280,0.544584,0,2,1669804,1669227,577
9963741,371.422,481.274,632,14069,0.567761,0,2,1670080,1669448,632
9965201,363.994,448.74,723,13976,0.615541,0,2,1670392,1669669,723
9979801,276.136,275.288,1114,16896,0.890108,0,2,1672948,1671834,1114
9981261,270.119,262.877,1166,16896,0.878845,0,2,1673176,1672010,1166
9981261,241.354,230.017,1206,16896,0.875239,0,2,1673216,1672010,1206
9981261,239.685,201.265,1434,16896,0.888334,0,2,1673444,1672010,1434
10004621,229.296,110.934,2410,7300,0.982272,0,2,1677872,1675462,2410
10020681,221.404,336.896,1117,11680,0.988294,0,2,1679204,1678087,1117
10026521,260.138,331.89,1080,5840,0.990638,0,2,1680472,1679392,1080
10027981,257.621,311.404,1152,5840,0.945558,0,2,1680712,1679560,1152
10029441,255.418,293.479,1224,5840,0.906113,0,2,1680952,1679728,1224
10029441,226.991,256.794,1252,5840,0.874099,0,2,1680980,1679728,1252
10029441,224.117,224.695,1456,5840,0.851087,0,2,1681184,1679728,1456
10029441,251.603,196.608,1900,5840,0.818451,0,2,1681628,1679728,1900
10029441,238.152,172.032,2044,14600,0.792395,0,2,1681772,1679728,2044
10029441,232.383,150.528,2236,16060,0.774595,0,2,1681964,1679728,2236
10038201,234.835,369.212,588,17520,0.766521,0,2,1682216,1681628,588
10039661,257.481,347.81,806,20159,0.781956,0,2,1682632,1681826,806
10049881,219.012,113.02,2248,7300,0.957822,0,2,1685420,1683172,2248
10052801,220.136,294.393,912,8760,0.959344,0,2,1685648,1684736,912
10052801,239.76,150.997,2232,13140,0.970397,0,2,1686968,1684736,2232
10052801,238.29,132.122,2460,1460,0.971598,0,2,1687196,1684736,2460
10095141,231.285,377.574,1033,10220,0.987742,0,2,1692884,1691851,1033
10095141,230.515,289.08,1489,11680,0.979365,0,2,1693340,1691851,1489
10095141,212.2,252.945,1573,13140,0.966944,0,2,1693424,1691851,1573
10095141,209.675,221.327,1765,14600,0.937326,0,2,1693616,1691851,1765
10095141,207.466,193.661,1957,5840,0.88641,0,2,1693808,1691851,1957
10095141,199.533,169.454,2101,5840,0.834359,0,2,1693952,1691851,2101
10095141,195.591,148.272,2269,5840,0.773814,0,2,1694120,1691851,2269
10095141,181.642,129.738,2353,5840,0.710837,0,1,1694204,1691851,2353
10095141,208.437,113.521,2749,1460,0.633233,0,1,1694600,1691851,2749
10117041,198.882,415.831,349,18980,0.562829,0,1,1694732,1694383,349
10119961,211.522,390.977,432,20440,0.497475,0,1,1695032,1694600,432
10121421,233.207,388.105,449,20391,0.435291,0,1,1695417,1694968,449
10124341,225.306,362.592,435,19376,0.384629,0,1,1695587,1695152,435
10127261,244.268,363.268,444,21375,0.350301,0,1,1695964,1695520,444
10130181,257.609,359.234,464,20582,0.335263,0,1,1696315,1695851,464
10133101,268.908,351.08,518,19322,0.344605,0,2,1696663,1696145,518
10134561,282.795,343.945,604,19605,0.37278,0,2,1697043,1696439,604
10137481,271.945,320.202,646,19364,0.417432,0,2,1697239,1696593,646
10140401,282.952,317.552,707,19252,0.481503,0,2,1697599,1696892,707
10150621,238.557,53.9559,3867,10220,0.937685,0,2,1701919,1698052,3867
10150621,237.237,47.2114,4095,11680,0.944224,0,2,1702147,1698052,4095
10150621,202.015,7.28048,6987,8760,0.990149,0,2,1705039,1698052,6987
10150621,204.589,2.85902,8439,16060,0.986131,0,2,1706491,1698052,8439
10150621,214.818,1.28311,9807,5840,0.977526,0,2,1707859,1698052,9807
10150621,216.465,1.12272,10035,5840,0.930335,0,2,1708087,1698052,10035
10150621,217.907,0.982383,10263,5840,0.894043,0,2,1708315,1698052,10263
10211941,342.482,510.716,2480,18980,0.955875,0,2,1714099,1711619,2480
10211941,230.791,78.7576,5244,21900,0.991946,0,2,1716863,1711619,5244
10211941,216.179,27.0618,6900,7300,0.994732,0,2,1718519,1711619,6900
10219241,205.678,278.041,2371,20240,0.997166,0,2,1720274,1717903,2371
10267421,213.139,312.843,1600,11680,0.990276,0,2,1722098,1720498,1600
10267421,210.496,273.738,1792,11680,0.965242,0,2,1722290,1720498,1792
10267421,207.559,239.521,1979,13140,0.934587,0,2,1722477,1720498,1979
10290201,382.617,436.986,1100,13140,0.959312,0,2,1726673,1725573,1100
10291661,244.032,139.286,2504,14600,0.986517,0,2,1728261,1725757,2504
10291661,231.086,54.6972,4052,11680,0.990955,0,2,1729809,1725757,4052
10291661,232.894,12.5908,6704,5840,0.996668,0,2,1732461,1725757,6704
10338381,201.467,218.661,2203,4380,0.975663,0,2,1735077,1732874,2203
10341301,207.784,400.704,780,4380,0.923705,0,2,1735329,1734549,780
10344221,217.811,388.116,768,4380,0.886992,0,2,1735617,1734849,768
10351521,213.084,368.101,720,20588,0.854868,0,2,1735797,1735077,720
10352981,229.449,353.589,812,24313,0.831759,0,2,1736141,1735329,812
10355901,229.768,345.39,756,23826,0.824039,0,2,1736373,1735617,756
10358821,246.047,341.216,804,23265,0.824784,0,2,1736733,1735929,804
10360281,261.291,337.564,860,22890,0.835436,0,2,1737101,1736241,860
10363201,247.13,314.869,852,22703,0.852257,0,2,1737249,1736397,852
10374881,232.082,135.234,2136,10220,0.957241,0,2,1739937,1737801,2136
10388021,247.192,328.849,1004,11680,0.97831,0,2,1741521,1740517,1004
10388021,230.292,129.138,2528,1460,0.987732,0,2,1743045,1740517,2528
10408461,230.017,153.221,2386,20296,0.990029,0,2,1745757,1743371,2386
10408461,228.265,134.069,2602,1460,0.986275,0,2,1745973,1743371,2602
10428901,200.372,292.243,1222,14600,0.990284,0,2,1747425,1746203,1222
10428901,204.492,171.307,2074,5840,0.988055,0,2,1748277,1746203,2074
10428901,204.431,149.894,2278,5840,0.968298,0,2,1748481,1746203,2278
10428901,205.877,131.157,2494,1460,0.936011,0,2,1748697,1746203,2494
10430361,205.642,351.513,804,5840,0.887759,0,2,1748901,1748097,804
10440581,200.937,330.074,792,21756,0.838039,0,2,1749069,1748277,792
10442041,211.82,314.314,876,23213,0.787034,0,2,1749357,1748481,876
10442041,194.342,275.025,948,23213,0.737405,0,2,1749429,1748481,948
10442041,183.55,240.647,1056,23213,0.703979,0,2,1749537,1748481,1056
10444961,198.106,297.316,662,23213,0.684732,0,2,1749837,1749175,662
10447881,213.843,300.152,666,22483,0.680391,0,2,1750161,1749495,666
10450801,232.112,302.633,706,21844,0.694092,0,2,1750521,1749815,706
10453721,255.598,304.804,806,21370,0.72358,0,2,1750941,1750135,806
10463941,214.654,98.393,2370,14600,0.938784,0,2,1753785,1751415,2370
10463941,217.822,86.0939,2610,16060,0.938936,0,2,1754025,1751415,2610
10477081,212.048,354.717,991,11680,0.967595,0,2,1755273,1754282,991
10504821,227.12,330.928,971,13140,0.988753,0,2,1758369,1757398,971
10519421,241.415,151.774,2280,5840,0.995982,0,2,1761993,1759713,2280
10519421,238.238,132.803,2496,4380,0.967735,0,2,1762209,1759713,2496
10519421,244.459,116.202,2784,1460,0.930518,0,2,1762497,1759713,2784
10528181,254.401,386.677,828,18980,0.892953,0,2,1762821,1761993,828
10529641,249.601,365.342,828,19834,0.860084,0,2,1763037,1762209,828
10529641,231.901,319.675,936,19834,0.838823,0,2,1763145,1762209,936
10532561,244.913,342.09,773,19834,0.82022,0,2,1763481,1762708,773
10534021,269.299,346.579,835,22400,0.821443,0,2,1763921,1763086,835
10536941,258.637,326.882,830,22215,0.832513,0,2,1764105,1763275,830
10547161,288.369,291.17,1138,21953,0.911594,0,2,1765697,1764559,1138
10548621,223.586,107.461,2443,10220,0.950873,0,2,1767153,1764710,2443
10548621,229.99,7.43723,6907,10220,0.98535,0,2,1771617,1764710,6907
10548621,212.513,2.92057,8287,16060,0.990497,0,2,1772997,1764710,8287
10548621,234.995,1.31074,9823,16887,0.991985,0,2,1774533,1764710,9823
10548621,246.655,0.768331,10843,5840,0.959052,0,2,1775553,1764710,10843
10602641,470.823,1537.92,585,18693,0.95042,0,2,1777593,1777008,585
10614321,282.263,397.813,2217,10220,0.969837,0,2,1780245,1778028,2217
10624541,275.48,541.211,900,11680,0.969858,0,2,1780473,1779573,900
10655201,245.172,252.326,1144,17776,0.991102,0,2,1785881,1784737,1144
10672721,215.044,248.075,1156,5840,0.954878,0,2,1788849,1787693,1156
10674181,243.164,300.691,927,5840,0.906768,0,2,1789289,1788362,927
10675641,239.768,290.979,920,5840,0.849672,0,2,1789505,1788585,920
10678561,228.297,282.482,845,5840,0.809713,0,2,1789653,1788808,845
10681481,244.76,307.297,724,20378,0.759749,0,2,1790013,1789289,724
10684401,262.165,319.885,700,19846,0.71103,0,2,1790397,1789697,700
10687321,268.394,327.899,628,19329,0.673402,0,2,1790709,1790081,628
10688781,286.845,334.912,660,18736,0.660476,0,2,1791125,1790465,660
10690241,277.989,317.048,684,18279,0.654167,0,2,1791341,1790657,684
10691701,270.241,301.417,708,17930,0.661146,0,2,1791557,1790849,708
10693161,264.961,287.74,744,17671,0.682253,0,2,1791785,1791041,744
10694621,261.841,275.772,792,17519,0.715721,0,2,1792025,1791233,792
10729661,228.602,264.209,1128,10220,0.991585,0,2,1798665,1797537,1128
1667961,1240.9,1319.04,656,5840,0.970165,0,2,57661,57005,656
1670881,1114.29,1174.91,718,8760,0.970145,0,2,57889,57171,718
1679641,439.14,297.198,2772,5840,0.986878,0,2,60697,57925,2772
1694241,304.654,362.001,979,14600,0.983597,0,2,62233,61254,979
1714681,246.949,155.255,2491,1460,0.993517,0,2,66517,64026,2491
1733661,223.323,317.392,1051,13140,0.991204,0,2,67969,66918,1051
1735121,250.407,325.718,1107,5840,0.961054,0,2,68409,67302,1107
1735121,222.606,285.003,1135,5840,0.933422,0,2,68437,67302,1135
1735121,223.281,249.378,1363,5840,0.885494,0,2,68665,67302,1363
1735121,250.871,218.205,1807,5840,0.813557,0,2,69109,67302,1807
1735121,231.512,190.93,1903,19588,0.740613,0,1,69205,67302,1903
1735121,213.073,167.064,1987,19588,0.681786,0,1,69289,67302,1987
1743881,216.439,372.056,420,19588,0.625313,0,1,69529,69109,420
1746801,220.884,346.549,504,19588,0.568399,0,1,69781,69277,504
1749721,235.273,345.23,504,19414,0.523599,0,1,70117,69613,504
1752641,250.864,344.076,528,18736,0.481899,0,1,70477,69949,528
1755561,258.506,343.067,504,18197,0.450412,0,1,70789,70285,504
1758481,272.693,342.183,540,17658,0.42286,0,1,71161,70621,540
1761401,277.606,341.411,516,17276,0.403753,0,1,71473,70957,516
1764321,290.905,340.734,564,16894,0.399534,0,2,71857,71293,564
1767241,302.542,340.142,612,16650,0.413342,0,2,72241,71629,612
1770161,314.225,339.625,672,16546,0.437924,0,2,72637,71965,672
1771621,323.946,339.172,728,16546,0.474434,0,2,73029,72301,728
1774541,309.453,317.775,768,16546,0.516379,0,2,73237,72469,768
1776001,318.271,320.053,812,16546,0.568082,0,2,73617,72805,812
1777461,303.988,301.047,848,18006,0.618322,0,2,73821,72973,848
1789141,244.252,108.439,2464,10220,0.919373,0,2,76645,74181,2464
1827101,229.82,340.108,1542,5840,0.990583,0,2,83101,81559,1542
1827101,259.592,297.594,2010,5840,0.96301,0,2,83569,81559,2010
1827101,314.143,260.395,2706,17520,0.933884,0,2,84265,81559,2706
1827101,301.875,227.846,2922,18980,0.913398,0,2,84481,81559,2922
1827101,283.641,199.365,3078,1460,0.905473,0,2,84637,81559,3078
1827101,273.686,174.444,3282,5840,0.903539,0,2,84841,81559,3282
1827101,270.975,152.639,3534,7300,0.909347,0,2,85093,81559,3534
1846081,238.403,498.364,758,10220,0.926844,0,2,85369,84611,758
1854841,221.348,229.927,1442,20383,0.96941,0,2,87901,86459,1442
1875281,252.653,170.717,2336,7300,0.987235,0,2,92377,90041,2336
1897181,298.069,375.938,1088,16060,0.976642,0,2,95397,94309,1088
1898641,290.81,356.946,1104,17520,0.965812,0,2,95637,94533,1104
1898641,257.959,312.328,1132,18980,0.953835,0,2,95665,94533,1132
1898641,270.714,273.287,1492,20440,0.953356,0,2,96025,94533,1492
1898641,262.375,239.126,1696,5840,0.955436,0,2,96229,94533,1696
1898641,247.578,209.235,1840,5840,0.949757,0,2,96373,94533,1840
1898641,236.131,183.081,1996,5840,0.934787,0,2,96529,94533,1996
1898641,229.114,160.196,2176,5840,0.914189,0,2,96709,94533,2176
1908861,242.475,352.171,816,1460,0.901165,0,2,97045,96229,816
1911781,255.666,336.15,940,18992,0.884769,0,2,97393,96453,940
1913241,253.707,350.131,732,18992,0.865423,0,2,97633,96901,732
1913241,248.994,306.365,948,18992,0.853495,0,2,97849,96901,948
1913241,244.87,268.069,1164,18992,0.848058,0,2,98065,96901,1164
1913241,241.261,234.56,1380,18992,0.855801,0,2,98281,96901,1380
1914701,266.103,320.615,897,18992,0.871326,0,2,98721,97824,897
1933681,224.316,107.634,2294,8760,0.985869,0,2,102805,100511,2294
1951201,226.021,276.622,1190,13140,0.991951,0,2,104413,103223,1190
1967261,266.984,308.926,1139,13140,0.984629,0,2,107471,106332,1139
1968721,262.111,294.061,1177,14600,0.97905,0,2,107699,106522,1177
1968721,227.741,225.14,1397,17520,0.97646,0,2,107919,106522,1397
1968721,224.774,196.998,1601,18980,0.973153,0,2,108123,106522,1601
1968721,218.677,172.373,1777,7300,0.972759,0,2,108299,106522,1777
1968721,215.342,150.826,1969,7300,0.972414,0,2,108491,106522,1969
1986241,238.34,284.133,1080,23532,0.97137,0,2,109951,108871,1080
1987701,237.047,272.367,1118,23532,0.937448,0,2,110179,109061,1118
1989161,234.416,262.071,1144,23532,0.901517,0,2,110395,109251,1144
1990621,226.614,253.062,1126,23532,0.867578,0,2,110567,109441,1126
1990621,208.787,221.429,1210,23532,0.84038,0,2,110651,109441,1210
1990621,196.189,193.751,1318,23532,0.811583,0,2,110759,109441,1318
1990621,185.165,169.532,1426,7300,0.788885,0,2,110867,109441,1426
1990621,172.52,148.34,1510,7300,0.766524,0,2,110951,109441,1510
1990621,170.455,129.798,1666,7300,0.744459,0,2,111107,109441,1666
1990621,171.648,113.573,1846,5840,0.722651,0,2,111287,109441,1846
2002301,159.192,264.126,600,5840,0.70607,0,2,111359,110759,600
2005221,173.793,244.611,768,5840,0.689061,0,2,111635,110867,768
2008141,198.569,266.534,720,5840,0.679179,0,2,112007,111287,720
2011061,220.248,276.717,744,25971,0.673031,0,2,112379,111635,744
2013981,239.217,288.628,744,25313,0.682652,0,2,112751,112007,744
2016901,249.815,288.049,784,24737,0.693571,0,2,113075,112291,784
2019821,257.588,287.543,812,24326,0.713124,0,2,113387,112575,812
2022741,267.389,287.1,864,24038,0.740234,0,2,113723,112859,864
2034421,247.966,120.205,2382,8760,0.937704,0,2,116519,114137,2382
2034421,246.97,105.18,2622,8760,0.932991,0,2,116759,114137,2622
2051941,229.968,139.161,2439,10220,0.984003,0,2,119627,117188,2439
2085521,240.446,354.241,998,10220,0.997485,0,2,123899,122901,998
2085521,240.39,309.961,1238,11680,0.965299,0,2,124139,122901,1238
2085521,240.341,271.216,1478,13140,0.927137,0,2,124379,122901,1478
2085521,232.799,237.314,1658,5840,0.884995,0,2,124559,122901,1658
2085521,214.199,207.65,1742,5840,0.83562,0,2,124643,122901,1742
2085521,202.424,181.693,1862,5840,0.784918,0,2,124763,122901,1862
2085521,186.121,158.982,1934,5840,0.745553,0,2,124835,122901,1934
2085521,174.856,139.109,2030,5840,0.708609,0,2,124931,122901,2030
2085521,161.999,121.72,2102,5840,0.668783,0,2,125003,122901,2102
2085521,185.249,106.505,2450,5840,0.626435,0,2,125351,122901,2450
2085521,181.593,93.1922,2606,1460,0.591881,0,2,125507,122901,2606
2085521,179.894,81.5432,2774,5840,0.566646,0,2,125675,122901,2774
2085521,170.907,71.3503,2882,7300,0.537065,0,2,125783,122901,2882
2105961,155.544,372.681,448,8760,0.513682,0,2,125831,125383,448
2105961,152.601,326.096,580,10220,0.493222,0,2,125963,125383,580
2105961,156.026,285.334,760,10220,0.482819,0,2,126143,125383,760
2108881,171.022,304.792,595,10220,0.473716,0,2,126419,125824,595
2111801,185.645,302.318,598,13140,0.473252,0,2,126707,126109,598
2114721,201.439,299.029,634,16060,0.467845,0,2,127019,126385,634
2117641,207.759,296.15,610,18980,0.468115,0,2,127271,126661,610
2120561,219.289,293.631,634,21900,0.46085,0,2,127571,126937,634
2123481,223.378,291.427,610,22089,0.461994,0,2,127823,127213,610
2126401,237.456,289.499,670,21602,0.472995,0,2,128159,127489,670
2129321,243.774,287.812,682,21348,0.49012,0,2,128447,127765,682
2132241,249.302,286.335,694,21158,0.510105,0,2,128735,128041,694
2135161,257.139,285.043,730,21010,0.532592,0,2,129047,128317,730
2138081,262.497,283.913,754,23909,0.562268,0,2,129347,128593,754
2141001,267.185,282.924,778,23909,0.598235,0,2,129647,128869,778
2143921,268.287,282.058,778,23909,0.639705,0,2,129923,129145,778
2174581,242.508,250.161,1188,10220,0.967883,0,2,135779,134591,1188
2199401,204.648,147.716,2317,5840,0.984027,0,2,139883,137566,2317
2199401,275.067,129.251,3085,1460,0.942274,0,2,140651,137566,3085
2206701,267.684,431.595,753,15989,0.89824,0,2,140867,140114,753
2208161,285.223,444.77,624,15989,0.85971,0,2,141275,140651,624
2216921,272.07,417.299,579,15989,0.833496,0,2,141455,140876,579
2218381,293.062,393.262,794,15989,0.813059,0,2,141895,141101,794
2219841,281.929,372.229,773,15899,0.805177,0,2,142099,141326,773
2221301,276.688,353.825,788,15782,0.795779,0,2,142339,141551,788
2222761,276.602,337.722,839,15705,0.795057,0,2,142615,141776,839
2224221,275.027,323.632,878,15705,0.801925,0,2,142879,142001,878
2225681,272.148,311.303,905,15705,0.817934,0,2,143131,142226,905
2227141,268.13,300.515,920,15705,0.834442,0,2,143371,142451,920
2228601,264.614,291.076,935,15705,0.848887,0,2,143611,142676,935
2230061,264.537,282.816,974,15705,0.866526,0,2,143875,142901,974
2247581,228.268,76.2096,2949,10220,0.988262,0,2,148415,145466,2949
2260721,248.075,163.92,2811,1460,0.992298,0,2,151259,148448,2811
2278241,239.32,341.535,1391,5840,0.986543,0,2,152639,151248,1391
2284081,284.872,383.958,1075,17945,0.975985,0,2,153763,152688,1075
2285541,298.763,384.838,1080,18042,0.942737,0,2,154159,153079,1080
2287001,288.418,366.734,1056,18042,0.911145,0,2,154375,153319,1056
2289921,270.866,350.892,964,18030,0.883502,0,2,154523,153559,964
2291381,283.008,367.03,852,17860,0.844314,0,2,154891,154039,852
2292841,274.632,351.152,828,17543,0.800025,0,2,155107,154279,828
2295761,267.803,337.258,808,17227,0.758772,0,2,155327,154519,808
2297221,284.827,355.1,732,16923,0.722675,0,2,155731,154999,732
2298681,276.224,340.713,708,16534,0.681091,0,2,155947,155239,708
2300141,270.196,328.124,696,16156,0.644704,0,2,156175,155479,696
2301601,264.921,317.108,684,15816,0.610366,0,2,156403,155719,684
2303061,261.806,307.47,684,15499,0.580321,0,2,156643,155959,684
2304521,256.08,299.036,660,16959,0.554031,0,2,156859,156199,660
2305981,251.07,291.657,636,17860,0.528527,0,2,157075,156439,636
2307441,249.687,285.199,636,17580,0.503711,0,2,157315,156679,636
2310361,242.976,273.55,640,17337,0.491997,0,2,157511,156871,640
2311821,263.104,287.356,660,18171,0.479247,0,2,157915,157255,660
2314741,250.216,275.436,628,17996,0.470591,0,2,158075,157447,628
2317661,266.939,286.632,647,17794,0.473018,0,2,158459,157812,647
2320581,280.071,294.053,673,17646,0.48264,0,2,158831,158158,673
2322041,294.063,300.546,719,17566,0.51606,0,2,159223,158504,719
2324961,283.305,284.603,754,17566,0.550303,0,2,159431,158677,754
2336641,229.111,112.758,2137,8760,0.900745,0,2,162371,160234,2137
2355621,239.287,144.201,2544,11680,0.982857,0,2,166123,163579,2544
2374601,226.045,403.217,1120,11680,0.991056,0,2,167407,166287,1120
2374601,228.415,352.815,1365,13140,0.987174,0,2,167652,166287,1365
2383361,230.554,212.63,1734,5840,0.992394,0,2,169867,168133,1734
2383361,218.235,186.051,1866,5840,0.982095,0,2,169999,168133,1866
2383361,211.956,162.795,2034,4380,0.960583,0,2,170167,168133,2034
2386281,249.961,359.195,816,4380,0.93176,0,2,170683,169867,816
2393581,236.716,339.421,759,18356,0.91154,0,2,170827,170068,759
2395041,250.127,322.118,902,19769,0.891347,0,2,171171,170269,902
2396501,266.861,333.603,872,19566,0.876179,0,2,171555,170683,872
2397961,259.003,317.028,875,19334,0.865407,0,2,171759,170884,875
2400881,251.128,302.524,870,19131,0.863481,0,2,171955,171085,870
2402341,274.737,314.959,908,18943,0.876796,0,2,172395,171487,908
2424241,217.454,176.216,1908,10220,0.988472,0,2,177175,175267,1908
2424241,220.273,154.189,2148,10220,0.983663,0,2,177415,175267,2148
2444681,246.612,320.484,1128,13140,0.984989,0,2,180135,179007,1128
2460741,261.151,400.922,1109,5840,0.984045,0,2,182899,181790,1109
2460741,258.507,350.806,1349,5840,0.957289,0,2,183139,181790,1349
2462201,279.693,391.706,1099,5840,0.913878,0,2,183567,182468,1099
2465121,285.732,396.617,996,5840,0.863393,0,2,183895,182899,996
2468041,284.515,403.54,820,18798,0.814219,0,2,184171,183351,820
2470961,304.451,421.098,720,18398,0.756192,0,2,184615,183895,720
2472421,318.394,424.96,684,17882,0.697918,0,1,185031,184347,684
2475341,303.095,400.09,654,17378,0.646928,0,1,185227,184573,654
2476801,315.708,406.579,606,16888,0.607312,0,2,185631,185025,606
2478261,304.745,384.007,608,16371,0.580148,0,2,185859,185251,608
2479721,295.152,364.256,610,15932,0.558879,0,2,186087,185477,610
2481181,291.258,346.974,648,17392,0.55027,0,2,186351,185703,648
2482641,286.35,331.852,674,18194,0.545236,0,2,186603,185929,674
2484101,282.057,318.621,700,18000,0.553331,0,2,186855,186155,700
2485561,272.3,301.293,724,17871,0.572915,0,2,187059,186335,724
2487021,266.762,286.131,772,17794,0.590051,0,2,187287,186515,772
2489941,256.417,272.865,776,17794,0.617544,0,2,187471,186695,776
2491401,279.365,283.757,856,18238,0.664101,0,2,187911,187055,856
2501621,229.25,102.497,2434,11680,0.922344,0,2,190651,188217,2434
2501621,230.593,89.685,2674,13140,0.910801,0,2,190891,188217,2674
2516221,232.466,347.235,984,11680,0.949968,0,2,192331,191347,984
2536661,225.515,73.9409,3708,5840,0.993224,0,2,197827,194119,3708
2536661,227.326,64.6982,3948,5840,0.957821,0,2,198067,194119,3948
2536661,227.41,56.611,4176,5840,0.920593,0,2,198295,194119,4176
2536661,282.984,49.5346,4848,17086,0.851769,0,2,198967,194119,4848
2536661,265.611,43.3428,4992,17086,0.781548,0,1,199111,194119,4992
2536661,247.41,37.9249,5112,17086,0.717605,0,1,199231,194119,5112
2536661,235.983,33.1843,5268,17086,0.651654,0,1,199387,194119,5268
2536661,227.485,29.0363,5436,17086,0.588947,0,1,199555,194119,5436
2536661,218.55,25.4067,5592,17086,0.526579,0,1,199711,194119,5592
2536661,212.231,22.2309,5760,1460,0.477006,0,1,199879,194119,5760
2536661,211.202,19.452,5964,5840,0.436131,0,1,200083,194119,5964
2568781,195.302,734.771,306,7300,0.390364,0,1,200167,199861,306
2568781,199.389,642.924,534,8760,0.350319,0,1,200395,199861,534
2571701,222.466,616.559,486,8760,0.322779,0,1,200779,200293,486
2573161,245.157,593.489,458,11680,0.303682,0,1,201183,200725,458
2574621,247.513,546.303,506,13140,0.281971,0,1,201447,200941,506
2576081,245.074,505.015,518,14600,0.270475,0,1,201675,201157,518
2577541,242.939,468.888,530,14855,0.262916,0,1,201903,201373,530
2579001,241.072,437.277,542,14517,0.261301,0,1,202131,201589,542
2580461,240.938,409.617,566,15977,0.259888,0,1,202371,201805,566
2581921,236.321,385.415,554,16964,0.276152,0,2,202575,202021,554
2584841,240.281,364.238,606,16775,0.297883,0,2,202843,202237,606
2587761,258.246,361.709,646,15850,0.326898,0,2,203227,202581,646
2589221,276.465,359.495,706,16782,0.379786,0,2,203631,202925,706
2592141,270.907,338.183,749,16782,0.438563,0,2,203863,203114,749
2606741,238.381,312.441,936,10220,0.904671,0,2,207271,206335,936
2606741,249.919,140.222,2532,13862,0.953467,0,2,208867,206335,2532
2606741,244.613,12.6754,6972,5840,0.992044,0,2,213307,206335,6972
2606741,242.537,11.091,7200,5840,0.988038,0,2,213535,206335,7200
2606741,242.22,9.70458,7440,14740,0.965783,0,2,213775,206335,7440
2650541,222.442,842.492,852,16200,0.938811,0,2,213859,213007,852
2650541,226.137,737.18,1104,16238,0.895209,0,2,214111,213007,1104
2650541,224.87,645.033,1320,16238,0.847058,0,2,214327,213007,1320
2650541,211.761,564.403,1440,16238,0.797426,0,2,214447,213007,1440
2653461,218.291,607.853,792,16238,0.751498,0,2,214711,213919,792
2656381,237.505,588.871,708,19018,0.70881,0,2,215083,214375,708
2659301,249.817,566.512,634,18761,0.666459,0,2,215419,214785,634
2660761,264.589,541.198,638,18416,0.639402,0,2,215787,215149,638
2663681,256.016,496.299,652,18121,0.620726,0,2,215983,215331,652
2666601,275.014,479.761,696,17891,0.624386,0,2,216391,215695,696
2668061,291.137,465.291,736,17750,0.640087,0,2,216795,216059,736
2669521,281.745,429.88,770,17698,0.661327,0,2,217011,216241,770
2672441,274.027,398.895,808,17698,0.684911,0,2,217231,216423,808
2682661,224.251,124.489,2280,7300,0.926969,0,2,220159,217879,2280
2692881,226.219,318.927,840,8760,0.928598,0,2,220399,219559,840
2720621,284.803,778.484,915,16866,0.985112,0,2,228229,227314,915
2732301,273.202,709.673,879,16866,0.963223,0,2,228421,227542,879
2735221,285.552,649.464,1023,18326,0.926571,0,2,228793,227770,1023
2738141,294.858,625.281,927,19786,0.879499,0,2,229153,228226,927
2741061,294.001,598.371,805,19786,0.833312,0,2,229441,228636,805
2743981,296.251,569.075,753,19696,0.795398,0,2,229753,229000,753
2746901,298.219,543.44,701,19427,0.762223,0,2,230065,229364,701
2748361,308.442,521.01,717,19107,0.735695,0,2,230445,229728,717
2749821,295.387,478.634,739,20567,0.719983,0,2,230649,229910,739
2752741,281.463,441.555,741,21499,0.711235,0,2,230833,230092,741
2755661,286.78,431.86,701,21307,0.706081,0,2,231157,230456,701
2758581,289.933,414.128,723,21051,0.716571,0,2,231469,230746,723
2761501,300.191,398.612,805,20874,0.74075,0,2,231841,231036,805
2771721,243.522,123.872,2513,10220,0.944032,0,2,234709,232196,2513
2790701,227.399,166.836,2448,18980,0.994111,0,2,239221,236773,2448
2809681,209.654,127.78,2667,21900,0.995342,0,2,242137,239470,2667
2809681,213.447,111.807,2907,23360,0.982174,0,2,242377,239470,2907
2809681,216.766,97.8313,3147,24820,0.966902,0,2,242617,239470,3147
2812601,213.671,402.477,804,25520,0.93979,0,2,242809,242005,804
2831581,213.962,368.293,891,25520,0.896066,0,2,243025,242134,891
2831581,208.217,322.256,1059,25520,0.855308,0,2,243193,242134,1059
2833041,188.19,314.224,849,25520,0.819644,0,2,243241,242392,849
2835961,175.166,291.071,804,25520,0.785939,0,2,243325,242521,804
2838881,168.27,270.812,795,25520,0.746446,0,2,243445,242650,795
2841801,171.236,269.211,729,25249,0.69939,0,2,243637,242908,729
2844721,178.332,267.809,699,24841,0.653217,0,2,243865,243166,699
2847641,177.04,266.583,609,24389,0.607815,0,1,244033,243424,609
2850561,180.41,265.51,555,23732,0.578088,0,2,244237,243682,555
2853481,187.859,264.572,537,23008,0.557077,0,2,244477,243940,537
2856401,201.877,263.75,579,22329,0.556192,0,2,244777,244198,579
2859321,218.642,263.031,657,21853,0.580418,0,2,245113,244456,657
2862241,227.312,262.402,687,21650,0.624116,0,2,245401,244714,687
2871001,267.375,248.235,1064,21559,0.777164,0,2,246681,245617,1064
2872461,223.67,91.6279,2487,11680,0.914681,0,2,248233,245746,2487
2898741,220.951,392.013,1020,11680,0.986083,0,2,252829,251809,1020
2927941,212.249,380.099,1104,5840,0.980622,0,2,255877,254773,1104
2927941,218.753,291.013,1584,5840,0.958914,0,2,256357,254773,1584
2927941,237.909,254.637,1956,5840,0.9028,0,2,256729,254773,1956
2927941,275.671,222.807,2496,18767,0.8237,0,1,257269,254773,2496
2927941,251.712,194.956,2580,20227,0.756987,0,1,257353,254773,2580
2927941,233.748,170.587,2688,21687,0.691114,0,1,257461,254773,2688
2927941,216.529,149.263,2784,23147,0.630975,0,1,257557,254773,2784
2927941,199.963,130.605,2868,1460,0.580853,0,1,257641,254773,2868
2927941,192.968,114.28,3012,5840,0.536996,0,1,257785,254773,3012
2927941,182.347,99.9948,3120,7300,0.492372,0,1,257893,254773,3120
2948381,173.053,444.37,373,8760,0.457075,0,1,258001,257628,373
2948381,166.422,388.824,493,10220,0.421191,0,1,258121,257628,493
2948381,159.119,340.221,601,10220,0.392292,0,1,258229,257628,601
2951301,175.229,347.193,493,10220,0.372005,0,1,258517,258024,493
2954221,181.825,335.294,469,13140,0.354255,0,1,258745,258276,469
2957141,190.597,324.882,469,16060,0.336223,0,1,258997,258528,469
2960061,201.273,315.772,493,18980,0.325445,0,1,259273,258780,493
2962981,212.114,307.801,529,21574,0.321014,0,1,259561,259032,529
2965901,218.599,300.826,541,21088,0.329638,0,2,259825,259284,541
2968821,227.274,294.722,577,20694,0.344683,0,2,260113,259536,577
2971741,231.865,289.382,589,23382,0.362848,0,2,260377,259788,589
2974661,240.382,284.709,637,23220,0.393742,0,2,260677,260040,637
2977581,237.334,277.371,627,23220,0.428274,0,2,260893,260266,627
2980501,236.167,267.699,655,23173,0.46349,0,2,261121,260466,655
2983421,235.147,259.237,683,23173,0.499303,0,2,261349,260666,683
2986341,237.253,251.832,735,23173,0.543141,0,2,261601,260866,735
2989261,237.597,245.353,775,23173,0.586498,0,2,261841,261066,775
2992181,234.897,239.684,791,23173,0.631936,0,2,262057,261266,791
3009701,213.934,55.6865,4134,13140,0.994822,0,2,269413,265279,4134
3009701,217.193,48.7257,4374,14600,0.979219,0,2,269653,265279,4374
3009701,247.095,21.8679,6030,5840,0.970674,0,2,271309,265279,6030
3009701,246.208,19.1344,6270,24820,0.949339,0,2,271549,265279,6270
3009701,245.432,16.7426,6510,26280,0.936922,0,2,271789,265279,6510
3041821,259.753,776.275,777,27740,0.918557,0,2,272149,271372,777
3046201,240.784,690.74,793,29200,0.912487,0,2,272257,271464,793
3047661,219.686,615.898,773,30660,0.897176,0,2,272329,271556,773
3062261,196.725,550.411,717,32023,0.881279,0,2,272365,271648,717
3065181,185.635,493.109,733,32023,0.874869,0,2,272473,271740,733
3068101,172.93,442.971,725,32023,0.869261,0,2,272557,271832,725
3071021,176.814,399.099,837,32023,0.869353,0,2,272761,271924,837
3073941,172.712,372.212,797,32023,0.869434,0,2,272905,272108,797
3076861,173.623,348.685,793,31960,0.874505,0,2,273085,272292,793
3079781,178.92,328.1,825,31833,0.888942,0,2,273301,272476,825
3110441,221.494,73.5999,3624,11680,0.989702,0,2,280417,276793,3624
3110441,220.807,64.3999,3840,13140,0.989739,0,2,280633,276793,3840
3110441,242.824,33.0313,5196,20440,0.992237,0,2,281989,276793,5196
3116281,204.28,684.596,1095,13140,0.980702,0,2,283261,282166,1095
3116281,208.745,599.022,1335,5840,0.951864,0,2,283501,282166,1335
3116281,212.652,524.144,1575,5840,0.951631,0,2,283741,282166,1575
3116281,207.07,458.626,1743,5840,0.953927,0,2,283909,282166,1743
3125041,376.186,722.548,733,21900,0.925936,0,2,285469,284736,733
3146941,333.663,644.729,669,23360,0.898944,0,2,285505,284836,669
3149861,308.455,576.638,701,24820,0.884076,0,2,285637,284936,701
3160081,277.398,517.058,661,26280,0.874817,0,2,285697,285036,661
3163001,271.224,464.926,789,27740,0.864215,0,2,285925,285136,789
3165921,259.821,431.81,769,30660,0.857438,0,2,286105,285336,769
3168841,255.843,402.834,797,31244,0.856508,0,2,286333,285536,797
3171761,247.863,377.48,789,30952,0.855695,0,2,286525,285736,789
3174681,240.88,355.295,781,30689,0.859983,0,2,286717,285936,781
3177601,234.77,335.883,773,30426,0.866235,0,2,286909,286136,773
3180521,236.924,318.898,825,30163,0.881705,0,2,287161,286336,825
3198041,218.533,98.512,2465,1460,0.977902,0,2,289981,287516,2465
3226501,453.856,470.275,1064,5840,0.989092,0,2,294891,293827,1064
3227961,342.231,217.469,2468,10220,0.992605,0,2,296395,293927,2468
3238181,306.577,319.994,1292,5840,0.976681,0,2,298075,296783,1292
3238181,298.255,279.995,1532,5840,0.963346,0,2,298315,296783,1532
3241101,469.473,570.621,595,1460,0.924178,0,2,299983,299388,595
3245481,488.789,573.668,624,13140,0.924905,0,2,300607,299983,624
3261541,290.784,361.442,948,1460,0.979875,0,2,303583,302635,948
3276141,225.125,127.085,2332,10220,0.993953,0,2,306535,304203,2332
3276141,214.319,7.69596,6940,11680,0.997134,0,2,311143,304203,6940
3276141,218.858,5.15569,7624,5840,0.99183,0,2,311827,304203,7624
3276141,203.501,4.51123,7720,5840,0.986601,0,2,311923,304203,7720
3276141,199.063,3.94733,7888,5840,0.972026,0,2,312091,304203,7888
3322861,355.066,273.368,3810,7300,0.994436,0,2,320335,316525,3810
3322861,340.683,239.197,4050,8760,0.992632,0,2,320575,316525,4050
3322861,216.058,4.35509,10264,19831,0.982366,0,2,326789,316525,10264
3322861,210.051,3.81071,10432,19831,0.97207,0,2,326957,316525,10432
3322861,206.295,3.33437,10612,19831,0.961811,0,2,327137,316525,10612
3322861,201.508,2.91757,10780,19831,0.957835,0,2,327305,316525,10780
3322861,191.319,2.55288,10900,5840,0.949356,0,2,327425,316525,10900
3322861,188.404,2.23377,11068,5840,0.934436,0,2,327593,316525,11068
3322861,190.354,1.95455,11272,5840,0.923882,0,2,327797,316525,11272
3322861,195.06,1.71023,11500,5840,0.914646,0,2,328025,316525,11500
3400241,264.163,339.8,2363,7300,0.975588,0,2,333269,330906,2363
3410461,247.694,224.936,2376,13140,0.987913,0,2,334913,332537,2376
3422141,237.503,370.778,1289,11680,0.985826,0,2,336293,335004,1289
3441121,222.011,322.699,1193,13140,0.995002,0,2,339149,337956,1193
3441121,224.484,126.722,2765,5840,0.996787,0,2,340721,337956,2765
3441121,226.424,110.882,3005,7300,0.993439,0,2,340961,337956,3005
3441121,225.121,97.0218,3221,5840,0.986759,0,2,341177,337956,3221
3455721,222.481,390.894,977,17520,0.974664,0,2,341381,340404,977
3455721,203.671,342.032,1049,18980,0.954081,0,2,341453,340404,1049
3455721,202.212,299.278,1241,18980,0.933571,0,2,341645,340404,1241
3455721,202.435,261.869,1445,18980,0.908125,0,2,341849,340404,1445
3458641,216.131,332.635,929,18980,0.880859,0,2,342161,341232,929
3461561,237.114,345.056,881,18952,0.857002,0,2,342545,341664,881
3463021,259.475,355.924,865,18695,0.839876,0,2,342961,342096,865
3464481,254.041,338.433,865,19824,0.827392,0,2,343177,342312,865
3465941,247.786,323.129,853,19587,0.820218,0,2,343381,342528,853
3467401,242.312,309.738,841,19349,0.821441,0,2,343585,342744,841
3468861,242.023,298.021,865,20809,0.825011,0,2,343825,342960,865
3470321,240.27,287.768,877,21898,0.828134,0,2,344053,343176,877
3471781,235.737,276.297,885,21780,0.843367,0,2,344257,343372,885
3476161,224.111,257.477,869,21661,0.876328,0,2,344633,343764,869
3487841,240.051,119.103,2360,10220,0.962782,0,2,347537,345177,2360
3487841,240.045,104.215,2600,11680,0.966184,0,2,347777,345177,2600
3522881,228.147,324.017,1046,13140,0.992325,0,2,352181,351135,1046
3534561,240.609,404.699,1070,5840,0.982204,0,2,355193,354123,1070
3534561,240.533,354.111,1310,5840,0.946929,0,2,355433,354123,1310
3534561,240.466,309.847,1550,5840,0.904813,0,2,355673,354123,1550
3534561,249.408,271.116,1862,5840,0.852961,0,2,355985,354123,1862
3534561,285.732,237.227,2402,20440,0.797591,0,2,356525,354123,2402
3534561,268.015,207.574,2546,21380,0.749142,0,2,356669,354123,2546
3534561,252.513,181.627,2690,1460,0.706749,0,2,356813,354123,2690
3534561,246.449,158.923,2894,5840,0.674656,0,2,357017,354123,2894
3550621,236.643,460.558,490,7300,0.651574,0,2,357185,356695,490
3550621,229.563,402.988,670,8760,0.633877,0,2,357365,356695,670
3552081,248.367,397.615,690,8760,0.625892,0,2,357745,357055,690
3555001,243.321,370.413,718,10220,0.626406,0,2,357953,357235,718
3556461,261.906,369.111,750,13140,0.641855,0,2,358345,357595,750
3557921,254.668,345.472,774,14600,0.670373,0,2,358549,357775,774
3560841,248.834,324.788,802,16060,0.705327,0,2,358757,357955,802
3571061,234.189,140.407,2098,8760,0.929669,0,2,361493,359395,2098
3571061,236.416,122.857,2350,8760,0.91471,0,2,361745,359395,2350
3571061,230.589,21.6522,5422,17753,0.977468,0,2,364817,359395,5422
3598801,228.927,753.628,1057,10220,0.989902,0,2,366413,365356,1057
3598801,210.29,132.819,3889,13140,0.98947,0,2,369245,365356,3889
3598801,214.003,116.217,4129,5840,0.959536,0,2,369485,365356,4129
3598801,217.253,101.69,4369,5840,0.907094,0,2,369725,365356,4369
3598801,215.596,88.9786,4573,5840,0.852458,0,2,369929,365356,4573
3598801,197.647,77.8563,4645,5840,0.80715,0,2,370001,365356,4645
3630921,372.441,799.124,393,18980,0.752507,0,2,371597,371204,393
3633841,364.886,717.734,557,20440,0.702193,0,2,371909,371352,557
3636761,359.775,665.017,585,23360,0.670669,0,2,372233,371648,585
3639681,352.303,618.89,589,22629,0.645585,0,2,372533,371944,589
3642601,353.265,578.529,653,21919,0.643637,0,2,372893,372240,653
3644061,353.607,543.213,713,21445,0.661933,0,2,373249,372536,713
3646981,327.906,493.811,713,22905,0.685441,0,2,373397,372684,713
3661581,234.954,343.572,900,10220,0.932062,0,2,376517,375617,900
3661581,235.585,300.626,1140,10220,0.935554,0,2,376757,375617,1140
3689321,226.173,157.404,2228,8760,0.988653,0,2,381125,378897,2228
3689321,229.552,31.704,4952,5840,0.990214,0,2,383849,378897,4952
3689321,232.358,27.741,5204,5840,0.960188,0,2,384101,378897,5204
3689321,237.814,24.2733,5480,5840,0.921414,0,2,384377,378897,5480
3714141,379.087,820.114,457,16060,0.852487,0,2,385745,385288,457
3719981,349.701,735.6,457,17520,0.797177,0,2,385889,385432,457
3722901,338.988,661.65,577,18980,0.750029,0,2,386153,385576,577
3725821,335.615,614.944,601,21900,0.712526,0,2,386465,385864,601
3728741,334.163,574.076,637,22406,0.69221,0,2,386789,386152,637
3731661,331.393,538.316,661,21878,0.686934,0,2,387101,386440,661
3734581,333.469,507.027,721,21493,0.693567,0,2,387449,386728,721
3737501,332.285,479.648,757,21290,0.715621,0,2,387773,387016,757
3747721,352.046,400.341,1113,21209,0.828302,0,2,389281,388168,1113
3749181,282.226,246.731,1693,24129,0.898104,0,2,390005,388312,1693
3749181,254.937,144.629,2550,14600,0.93777,0,2,390862,388312,2550
3749181,218.403,49.6959,4122,13140,0.971117,0,2,392434,388312,4122
3749181,213.143,1.54358,9917,5840,0.990353,0,2,398229,388312,9917
3809041,446.148,693.429,2185,5840,0.994185,0,2,404518,402333,2185
3819261,396.332,738.032,996,7300,0.994298,0,2,404986,403990,996
3847661,227.77,186.219,1868,8760,0.977345,0,2,411985,410117,1868
3850581,227.799,329.442,764,10220,0.931427,0,2,412213,411449,764
3859341,226.324,299.761,888,10220,0.876249,0,2,412429,411541,888
3859341,222.034,262.291,1080,10220,0.827967,0,2,412621,411541,1080
3859341,207.779,229.505,1188,11680,0.780721,0,2,412729,411541,1188
3859341,198.307,200.817,1320,13140,0.731881,0,2,412861,411541,1320
3859341,184.019,175.715,1404,13140,0.696646,0,2,412945,411541,1404
3859341,164.016,153.75,1428,14600,0.665815,0,2,412969,411541,1428
3859341,163.014,134.532,1584,16060,0.641339,0,2,413125,411541,1584
3859341,163.638,117.715,1752,5840,0.614921,0,2,413293,411541,1752
3871021,168.683,288.251,474,5840,0.593056,0,2,413497,413023,474
3873941,191.097,274.344,645,5840,0.575174,0,2,413845,413200,645
3876861,204.71,277.051,649,20461,0.572027,0,2,414145,413496,649
3879781,227.122,286.045,684,23381,0.584274,0,2,414529,413845,684
3882701,239.231,287.289,712,23083,0.61249,0,2,414853,414141,712
3884161,258.327,288.378,808,22609,0.659678,0,2,415245,414437,808
3898761,224.982,179.191,2473,18980,0.976929,0,2,420997,418524,2473
3929421,211.566,241.177,2053,5840,0.992931,0,2,426089,424036,2053
3929421,206.12,211.03,2221,5840,0.972565,0,2,426257,424036,2221
3949861,313.855,534.651,489,24820,0.922244,0,2,427325,426836,489
3952781,291.123,483.82,493,26280,0.880714,0,2,427457,426964,493
3955701,275.733,439.342,533,27488,0.854374,0,2,427625,427092,533
3967381,259.266,400.424,549,27488,0.836328,0,2,427769,427220,549
3970301,264.358,366.371,721,27488,0.835537,0,2,428069,427348,721
3973221,265.813,352.575,741,26781,0.847345,0,2,428345,427604,741
4038921,223.989,487.343,1254,5840,0.983499,0,2,439601,438347,1254
4040381,243.49,492.8,1103,5840,0.949311,0,2,439981,438878,1103
4043301,245.054,478.075,984,5840,0.914397,0,2,440237,439253,984
4044761,249.922,456.316,964,19755,0.878848,0,2,440521,439557,964
4046221,260.682,452.276,876,21215,0.852742,0,2,440857,439981,876
4049141,246.597,427.742,768,22675,0.827399,0,2,441005,440237,768
4052061,256.272,412.274,788,23032,0.817724,0,2,441329,440541,788
4054981,260.238,398.74,772,22706,0.816759,0,2,441617,440845,772
4090021,234.001,184.719,1744,11680,0.979308,0,2,447689,445945,1744
4091481,233.982,167.693,2286,16060,0.990832,0,2,450557,448271,2286
4110461,212.748,174.586,2274,5840,0.98914,0,2,452969,450695,2274
4126521,312.155,476.763,690,1460,0.929247,0,2,453977,453287,690
4129441,358.635,503.418,684,18980,0.884341,0,2,454661,453977,684
4132361,358.806,483.24,702,20897,0.855049,0,2,455021,454319,702
4135281,364.955,465.585,768,20421,0.834418,0,2,455429,454661,768
4136741,365.336,450.262,793,20150,0.836365,0,2,455797,455004,793
4139661,344.169,415.479,817,19963,0.83807,0,2,455993,455176,817
4142581,352.148,406.545,881,19844,0.852061,0,2,456401,455520,881
4155721,252.431,151.678,2185,7300,0.966453,0,2,459425,457240,2185
4165941,250.877,324.843,888,7300,0.958146,0,2,459665,458777,888
4165941,261.718,166.615,2268,10220,0.972283,0,2,461045,458777,2268
4182001,233.886,297.571,964,11680,0.986616,0,2,462557,461593,964
4189301,275.636,285.967,1174,16361,0.991885,0,2,464221,463047,1174
4199521,250.329,331.548,996,8760,0.994313,0,2,465797,464801,996
4199521,263.164,194.347,2124,4380,0.994167,0,2,466925,464801,2124
4199521,260.268,170.054,2364,4380,0.954896,0,2,467165,464801,2364
4208281,257.735,381.297,744,17821,0.939284,0,2,467405,466661,744
4211201,287.018,366.635,972,21320,0.933123,0,2,467897,466925,972
4214121,293.141,372.931,891,18918,0.927733,0,2,468233,467342,891
4215581,303.998,370.564,917,18753,0.933016,0,2,468613,467696,917
4238941,229.984,199.639,1584,11680,0.984702,0,2,472877,471293,1584
4238941,231.236,174.684,1824,11680,0.982864,0,2,473117,471293,1824
4238941,232.332,152.849,2064,1460,0.983756,0,2,473357,471293,2064
4250621,207.709,251.16,947,10220,0.99146,0,2,474497,473550,947
4263761,247.371,187.364,1848,10220,0.99453,0,2,477569,475721,1848
4273981,234.246,195.901,1592,5840,0.995352,0,2,479141,477549,1592
4279821,252.926,147.673,2256,10220,0.992914,0,2,480737,478481,2256
4279821,249.81,129.214,2484,1460,0.9888,0,2,480965,478481,2484
4301721,180.254,220.996,948,16060,0.996172,0,2,482609,481661,948
4304641,195.222,222.371,1016,18980,0.9929,0,2,482909,481893,1016
4307561,203.82,231.825,982,21900,0.990038,0,2,483173,482191,982
4323621,208.141,74.3936,2710,16060,0.997406,0,2,486437,483727,2710
4339681,191.754,327.879,1072,14600,0.994109,0,2,487889,486817,1072
4339681,197.785,286.894,1312,16060,0.991095,0,2,488129,486817,1312
4349901,207.791,43.9283,4500,14600,0.993565,0,2,493889,489389,4500
4349901,199.673,17.2505,5916,23360,0.996223,0,2,495305,489389,5916
4365961,209.214,699.094,720,24820,0.984195,0,2,495581,494861,720
4399541,210.062,623.332,843,26280,0.981171,0,2,495797,494954,843
4399541,206.305,545.416,1023,27740,0.972274,0,2,495977,494954,1023
4399541,185.016,477.239,1059,27740,0.96449,0,2,496013,494954,1059
4402461,173.889,447.709,914,27740,0.962679,0,2,496109,495195,914
4422901,227.347,93.6769,2914,7300,0.989964,0,2,499301,496387,2914
4422901,204.928,81.9673,2962,8760,0.989969,0,2,499349,496387,2962
4450641,219.978,317.774,1061,11680,0.99548,0,2,502085,501024,1061
4450641,225.303,42.8785,4349,14600,0.99564,0,2,505373,501024,4349
4456481,244.278,612.744,1185,10220,0.988043,0,2,506957,505772,1185
4456481,258.29,274.996,2805,5840,0.990884,0,2,508577,505772,2805
4497361,192.389,151.556,2050,10220,0.99502,0,2,511361,509311,2050
4548461,219.362,231.261,1584,8760,0.996214,0,2,519233,517649,1584
4552841,274.496,410.436,825,7300,0.990281,0,2,520673,519848,825
4555761,226.614,181.172,1868,17520,0.987433,0,2,522065,520197,1868
4555761,194.005,62.2523,3272,11680,0.981932,0,2,523469,520197,3272
4555761,202.755,54.4708,3536,13140,0.972941,0,2,523733,520197,3536
4571821,507.821,1382.32,763,1460,0.99291,0,2,532005,531242,763
4624381,362.716,501.742,2048,17520,0.996618,0,2,534933,532885,2048
4624381,347.376,439.024,2288,18252,0.993291,0,2,535173,532885,2288
4687161,242.024,256.546,1133,17520,0.976225,0,2,545349,544216,1133
4688621,241.771,249.853,1170,18980,0.959197,0,2,545589,544419,1170
4688621,216.55,218.621,1210,19444,0.948048,0,2,545629,544419,1210
4688621,217.981,191.294,1438,19444,0.948292,0,2,545857,544419,1438
4688621,213.233,167.382,1618,19444,0.943505,0,2,546037,544419,1618
4688621,207.579,146.459,1786,5840,0.939317,0,2,546205,544419,1786
4688621,207.132,128.152,1990,5840,0.945652,0,2,546409,544419,1990
4707601,224.013,143.337,1972,7300,0.987803,0,2,549193,547221,1972
4722201,231.158,121.549,2522,10220,0.988119,0,2,552601,550079,2522
4748481,248.112,292.798,1128,18980,0.996357,0,2,555609,554481,1128
4749941,229.669,126.088,2398,11680,0.992319,0,2,557077,554679,2398
4768921,186.89,341.155,924,13140,0.994484,0,2,558241,557317,924
4787901,142.046,206.714,960,5840,0.984618,0,2,561193,560233,960
4787901,154.29,180.875,1200,5840,0.979041,0,2,561433,560233,1200
4812721,161.806,75.3357,2733,5840,0.991162,0,2,570187,567454,2733
4812721,170.08,65.9187,2961,7300,0.988517,0,2,570415,567454,2961
4862361,174.833,57.304,2788,5840,0.986462,0,2,573481,570693,2788
4898861,152.612,217.665,988,18060,0.980769,0,2,577601,576613,988
4914001,160.536,216.457,996,19520,0.966923,0,2,577817,576821,996
4922761,245.86,26.8259,5897,7300,0.992576,0,2,586253,580356,5897
4922761,243.628,23.4727,6125,8760,0.964754,0,2,586481,580356,6125
4922761,243.174,20.5386,6365,10220,0.94791,0,2,586721,580356,6365
4922761,238.277,17.9713,6569,11680,0.950671,0,2,586925,580356,6569
4922761,229.956,3.61972,9317,19594,0.981314,0,2,589673,580356,9317
4922761,255.223,1.62451,10961,19594,0.986614,0,2,591317,580356,10961
4985541,255.039,988.206,1154,19808,0.992243,0,2,592981,591827,1154
5003061,253.885,443.997,1160,10220,0.988804,0,2,596149,594989,1160
5004521,235.213,186.473,2460,10220,0.993103,0,2,597665,595205,2460
5039561,227.108,126.642,2197,8760,0.99847,0,2,603377,601180,2197
5049781,225.719,302.937,876,1460,0.996161,0,2,603593,602717,876
5055621,212.879,209.402,1347,11680,0.984743,0,2,605009,603662,1347
5073141,238.761,266.995,1173,16060,0.994811,0,2,608149,606976,1173
5093581,216.031,371.313,932,5840,0.987225,0,2,612573,611641,932
5095041,216.027,347.399,968,5840,0.987572,0,2,612789,611821,968
5102341,216.024,333.974,944,5840,0.987875,0,2,613005,612061,944
5105261,204.021,314.727,884,5840,0.988141,0,2,613125,612241,884
5115481,218.331,121.595,2256,7300,0.995111,0,2,615981,613725,2256
5162201,221.863,45.8054,3998,11680,0.994986,0,2,625941,621943,3998
5162201,222.63,40.0797,4226,11680,0.991863,0,2,626169,621943,4226
5208921,254.548,169.193,2290,1460,0.997279,0,2,633321,631031,2290
5232281,251.583,131.474,2444,7300,0.992219,0,2,637833,635389,2444
5255641,238.577,283.147,1092,17520,0.997183,0,2,640721,639629,1092
5257101,234.255,275.503,1074,18881,0.991285,0,2,640925,639851,1074
5258561,234.973,270.19,1081,18881,0.991124,0,2,641165,640084,1081
5284841,220.862,273.039,1445,11680,0.991698,0,2,645381,643936,1445
5302361,267.876,289.079,1104,26713,0.984339,0,2,648581,647477,1104
5303821,264.392,271.444,1196,26713,0.985047,0,2,648821,647625,1196
5319881,208.525,265.841,1097,11680,0.986732,0,2,651609,650512,1097
5346161,180.479,291.763,974,16060,0.997184,0,2,654441,653467,974
5346161,187.919,255.293,1214,17520,0.990036,0,2,654681,653467,1214
5346161,181.986,130.942,2102,8760,0.987389,0,2,655569,653467,2102
5346161,175.737,114.574,2234,8760,0.986466,0,2,655701,653467,2234
5346161,179.27,100.252,2438,1460,0.981907,0,2,655905,653467,2438
5379741,326.884,355.003,1156,26529,0.989614,0,2,660585,659429,1156
5381201,245.228,129.443,2568,8760,0.992681,0,2,662149,659581,2568
5395801,223.337,105.421,2760,5840,0.992621,0,2,665149,662389,2760
5395801,225.42,92.2432,3000,7300,0.991044,0,2,665389,662389,3000
5395801,222.493,47.3123,4092,13140,0.991656,0,2,666481,662389,4092
5395801,238.995,21.2336,5616,5840,0.986255,0,2,668005,662389,5616
5395801,239.121,18.5794,5856,7300,0.984223,0,2,668245,662389,5856
5432301,235.88,436.178,1080,5840,0.99042,0,2,669609,668529,1080
5439601,304.178,441.641,1052,5840,0.991082,0,2,670869,669817,1052
5441061,296.156,410.311,1101,21838,0.985947,0,2,671109,670008,1101
5454201,270.407,216.47,1882,1460,0.993803,0,2,673897,672015,1882
5498001,281.512,350.356,1131,13140,0.996137,0,2,681437,680306,1131
5499461,244.017,170.509,2164,8760,0.985766,0,2,682677,680513,2164
5499461,243.515,149.196,2404,8760,0.961296,0,2,682917,680513,2404
5499461,241.575,130.546,2632,18980,0.952384,0,2,683145,680513,2632
5508221,253.769,406.45,768,19689,0.962294,0,2,683733,682965,768
5528661,278.33,301.85,1119,23936,0.986163,0,2,686273,685154,1119
5581221,199.821,236.043,1206,14600,0.997461,0,2,695505,694299,1206
5581221,201.843,206.538,1422,14600,0.990278,0,2,695721,694299,1422
5598741,185.275,95.1028,2588,1460,0.988077,0,2,699873,697285,2588
5610421,170.038,189.856,1264,14600,0.995165,0,2,701385,700121,1264
5610421,178.783,166.124,1504,14600,0.98577,0,2,701625,700121,1504
5610421,278.349,15.0168,5860,7300,0.991214,0,2,705981,700121,5860
5610421,273.555,13.1397,6100,8760,0.989812,0,2,706221,700121,6100
5610421,198.08,1.77299,8944,5840,0.993625,0,2,709065,700121,8944
5610421,203.32,1.55137,9184,5840,0.980672,0,2,709305,700121,9184
5706781,212.346,294.213,1003,11680,0.977231,0,2,717873,716870,1003
5706781,215.803,257.437,1243,13140,0.970077,0,2,718113,716870,1243
5727221,203.767,119.462,2340,8760,0.994179,0,2,722325,719985,2340
5738901,208.296,302.529,996,1460,0.986157,0,2,722565,721569,996
5738901,210.759,264.713,1224,5840,0.981637,0,2,722793,721569,1224
5753501,204.166,92.8169,2371,14600,0.996853,0,2,726153,723782,2371
5775401,199.129,311.617,1056,14600,0.992669,0,2,727689,726633,1056
5775401,181.82,107.074,2463,1460,0.986231,0,2,729096,726633,2463
5822961,386.597,648.588,714,1460,0.983464,0,2,735294,734580,714
5825881,519.968,489.322,2404,10220,0.982579,0,2,740076,737672,2404
5837561,247.812,151.658,2530,1460,0.989813,0,2,743040,740510,2530
5837561,246.835,132.701,2770,5840,0.988587,0,2,743280,740510,2770
5863841,160.503,281.787,996,20440,0.994873,0,2,744600,743604,996
5884281,218.505,120.124,2686,5840,0.994689,0,2,748968,746282,2686
5884281,221.192,105.109,2926,7300,0.979103,0,2,749208,746282,2926
5884281,222.043,91.9699,3154,8760,0.970465,0,2,749436,746282,3154
5884281,212.288,80.4737,3298,10220,0.960407,0,2,749580,746282,3298
5890121,188.752,368.914,934,11680,0.951606,0,2,749604,748670,934
5891581,168.158,333.3,874,13140,0.948906,0,2,749628,748754,874
5903261,154.638,302.138,850,14600,0.941542,0,2,749688,748838,850
5903261,147.308,264.37,946,16060,0.9326,0,2,749784,748838,946
5906181,136.395,252.324,838,16060,0.922275,0,2,749844,749006,838
5907641,141.845,246.034,816,17520,0.91074,0,2,750024,749208,816
5910561,148.115,243.779,780,18980,0.898148,0,2,750216,749436,780
5913481,155.1,231.307,840,20440,0.882129,0,2,750420,749580,840
5916401,155.213,223.394,828,23360,0.875613,0,2,750576,749748,828
5919321,156.811,216.469,828,26280,0.874911,0,2,750744,749916,828
5922241,152.21,210.411,780,29200,0.884298,0,2,750864,750084,780
5925161,155.684,205.109,792,32120,0.89251,0,2,751044,750252,792
5928081,160.223,200.471,816,35040,0.899697,0,2,751236,750420,816
5948521,175.474,50.7081,2640,13140,0.984638,0,2,754320,751680,2640
5952901,190.328,103.753,2669,1460,0.989177,0,2,757284,754615,2669
5990861,183.13,235.36,1317,14600,0.991746,0,2,758892,757575,1317
5990861,219.14,41.4798,4149,11680,0.996045,0,2,761724,757575,4149
5990861,245.655,24.3147,5289,5840,0.967682,0,2,762864,757575,5289
5998161,352.948,754.025,531,24820,0.907972,0,2,763968,763437,531
6011301,329.83,683.272,511,23157,0.848225,0,2,764136,763625,511
6021521,312.601,621.363,515,23157,0.793447,0,2,764328,763813,515
6024441,315.526,567.193,663,23157,0.758016,0,2,764664,764001,663
6027361,312.085,533.794,651,22551,0.734514,0,2,764952,764301,651
6028821,313.075,504.569,671,21992,0.71895,0,2,765272,764601,671
6031741,298.44,460.248,717,21542,0.715331,0,2,765468,764751,717
6034661,303.135,440.217,753,21246,0.724665,0,2,765804,765051,753
6037581,305.743,422.69,777,21060,0.750332,0,2,766128,765351,777
6049261,259.718,153.624,2355,11680,0.935029,0,2,769044,766689,2355
6059481,281.754,382.639,1089,8760,0.957926,0,2,770556,769467,1089
6082841,207.443,295.734,1021,13140,0.989323,0,2,773532,772511,1021
6090141,180.135,275.904,1186,5840,0.983739,0,2,776532,775346,1186
6090141,190.618,241.416,1450,5840,0.959522,0,2,776796,775346,1450
6101821,378.291,531.364,581,17520,0.910832,0,2,778488,777907,581
6103281,344.505,478.818,578,18980,0.873228,0,2,778596,778018,578
6110581,314.942,432.841,575,20440,0.840324,0,2,778704,778129,575
6113501,287.574,392.611,560,21900,0.819034,0,2,778800,778240,560
6116421,283.127,357.41,701,23360,0.810405,0,2,779052,778351,701
6119341,277.736,340.483,719,26280,0.807854,0,2,779292,778573,719
6122261,271.519,325.673,725,28555,0.810622,0,2,779520,778795,725
6125181,267.579,312.714,743,28081,0.828044,0,2,779760,779017,743
6128101,270.132,301.375,809,27713,0.845789,0,2,780048,779239,809
6155841,208.82,312.757,1078,14600,0.98646,0,2,785916,784838,1078
6174821,209.365,97.7856,3180,29200,0.993269,0,2,790992,787812,3180
6186501,237.194,426.812,882,30660,0.964111,0,2,791424,790542,882
6187961,216.545,381.461,890,32120,0.932347,0,2,791496,790606,890
6189421,190.977,341.778,838,33580,0.909554,0,2,791508,790670,838
6190881,179.105,307.056,870,35040,0.887109,0,2,791604,790734,870
6209861,162.717,276.674,854,36500,0.862471,0,2,791652,790798,854
6212781,146.877,250.09,826,37960,0.840912,0,2,791688,790862,826
6214241,131.517,226.829,786,39420,0.824548,0,2,791712,790926,786
6217161,124.078,206.475,794,40880,0.812729,0,2,791784,790990,794
6220081,119.068,188.666,814,42340,0.797388,0,2,791868,791054,814
6223001,114.685,181.082,770,45260,0.783965,0,2,791952,791182,770
6225921,112.349,174.447,738,46737,0.772219,0,2,792048,791310,738
6228841,114.805,168.641,742,45881,0.761942,0,2,792180,791438,742
6231761,113.955,163.561,722,45624,0.757949,0,2,792288,791566,722
6234681,116.21,159.116,726,44849,0.754455,0,2,792420,791694,726
6237601,113.684,155.226,694,44210,0.751398,0,2,792516,791822,694
6240521,117.474,151.823,710,43434,0.753724,0,2,792660,791950,710
6243441,120.789,148.845,726,42887,0.753258,0,2,792804,792078,726
6246361,120.691,146.24,718,42476,0.770351,0,2,792924,792206,718
6249281,122.104,143.96,722,42066,0.782807,0,2,793056,792334,722
6252201,124.841,141.965,738,41746,0.806206,0,2,793200,792462,738
6271181,136.532,35.1163,2410,15360,0.974979,0,2,795768,793358,2410
6271181,147.966,30.7268,2638,1460,0.969357,0,2,795996,793358,2638
6271181,159.47,26.886,2878,5840,0.970687,0,2,796236,793358,2878
6287241,158.45,220.286,996,17520,0.986187,0,2,797604,796608,996
6308441,403.33,288.577,2482,10220,0.99182,0,2,803622,801140,2482
6315741,406.911,384.922,1680,5840,0.96077,0,2,804822,803142,1680
6318661,440.047,546.807,672,5840,0.924424,0,2,805494,804822,672
6318661,466.041,478.456,1320,1460,0.897621,0,2,806142,804822,1320
6318661,425.786,418.649,1464,5840,0.884168,0,2,806286,804822,1464
6320121,381.563,475.443,663,7300,0.869897,0,2,806358,805695,663
6382901,243.101,305.452,1188,11680,0.995773,0,2,816422,815234,1188
6382901,217.713,267.271,1228,13140,0.995051,0,2,816462,815234,1228
6382901,213.917,119.95,2500,5840,0.981529,0,2,817734,815234,2500
6382901,215.677,104.956,2728,16060,0.930088,0,2,817962,815234,2728
6382901,217.217,91.8366,2956,17520,0.887577,0,2,818190,815234,2956
6385821,242.565,421.357,648,18980,0.82038,0,2,818610,817962,648
6387281,224.245,388.687,584,20440,0.764082,0,2,818706,818122,584
6397501,208.214,360.101,520,21900,0.707322,0,2,818802,818282,520
6401881,201.687,335.089,516,23360,0.657657,0,2,818958,818442,516
6404801,203.476,313.203,572,23761,0.6167,0,2,819174,818602,572
6407721,218.542,314.052,576,22757,0.575862,0,1,819498,818922,576
6410641,228.724,314.796,556,21881,0.545129,0,2,819798,819242,556
6413561,240.634,315.446,560,21060,0.520738,0,2,820122,819562,560
6416481,251.054,316.016,564,20366,0.494396,0,2,820446,819882,564
6419401,260.173,316.514,568,19764,0.473846,0,2,820770,820202,568
6422321,266.651,316.949,560,19235,0.450866,0,1,821082,820522,560
6425241,275.32,317.331,576,21680,0.445757,0,2,821418,820842,576
6428161,278.405,317.664,556,21297,0.441288,0,2,821718,821162,556
6431081,282.604,309.956,612,20914,0.452377,0,2,822030,821418,612
6434001,280.279,303.212,620,20713,0.46958,0,2,822294,821674,620
6436921,284.244,297.31,676,20549,0.499632,0,2,822606,821930,676
6439841,283.213,292.147,696,20549,0.538428,0,2,822882,822186,696
6441301,290.812,287.628,784,20549,0.584875,0,2,823226,822442,784
6452981,223.492,84.8176,2668,13140,0.915588,0,2,826134,823466,2668
6452981,225.555,74.2154,2908,14600,0.91739,0,2,826374,823466,2908
6455901,217.659,65.5229,4146,11680,0.982497,0,2,830778,826632,4146
6455901,226.744,15.0828,6750,5840,0.984721,0,2,833382,826632,6750
6455901,226.901,13.1975,6978,20439,0.945381,0,2,833610,826632,6978
6490941,272.039,857.548,798,21899,0.923458,0,2,834198,833400,798
6492401,250.034,766.854,762,23359,0.896776,0,2,834294,833532,762
6508461,229.279,687.498,714,24377,0.875929,0,2,834378,833664,714
6511381,215.62,618.06,702,24377,0.852688,0,2,834498,833796,702
6520141,202.167,557.303,678,24377,0.837352,0,2,834606,833928,678
6523061,211.396,504.14,822,24377,0.833933,0,2,834882,834060,822
6525981,210.472,474.122,762,24288,0.825941,0,2,835086,834324,762
6528901,224.663,447.857,822,24045,0.831449,0,2,835410,834588,822
6531821,231.08,424.875,834,26899,0.848768,0,2,835686,834852,834
6582921,197.807,275.915,1308,14600,0.997669,0,2,843018,841710,1308
6606281,175.607,221.073,1512,5840,0.997316,0,2,846198,844686,1512
6612121,324.502,464.976,705,1460,0.964452,0,2,847926,847221,705
6617961,367.939,494.979,672,27740,0.960145,0,2,848598,847926,672
6619421,342.947,446.607,732,29200,0.963877,0,2,848766,848034,732
6634021,252.633,119.31,2688,13140,0.986474,0,2,851478,848790,2688
6664681,216.374,108.27,2483,11680,0.991564,0,2,855798,853315,2483
6664681,219.327,94.7363,2723,11680,0.981368,0,2,856038,853315,2723
6685121,222.239,174.03,2034,20440,0.983747,0,2,858750,856716,2034
6685121,224.459,152.276,2274,21900,0.978279,0,2,858990,856716,2274
6685121,197.135,68.3409,3354,10220,0.987752,0,2,860070,856716,3354
6693881,197.993,376.798,1022,11680,0.968033,0,2,860274,859252,1022
6696801,198.744,353.948,1032,13140,0.939529,0,2,860478,859446,1032
6696801,196.401,309.705,1212,14600,0.900838,0,2,860658,859446,1212
6696801,177.851,270.992,1260,16060,0.869483,0,2,860706,859446,1260
6696801,175.119,237.118,1416,17520,0.832048,0,2,860862,859446,1416
6696801,160.729,207.478,1476,17520,0.804292,0,2,860922,859446,1476
6696801,157.138,181.543,1608,18980,0.777505,0,2,861054,859446,1608
6696801,146.496,158.85,1680,20440,0.751567,0,2,861126,859446,1680
6696801,141.684,138.994,1788,21900,0.733871,0,2,861234,859446,1788
6696801,141.973,121.62,1932,23360,0.713387,0,2,861378,859446,1932
6696801,136.227,106.417,2028,24820,0.697964,0,2,861474,859446,2028
6696801,138.698,93.1152,2184,26280,0.676968,0,2,861630,859446,2184
6696801,136.361,81.4758,2304,27740,0.663597,0,2,861750,859446,2304
6696801,135.816,71.2913,2436,28874,0.651898,0,2,861882,859446,2436
6696801,139.839,62.3799,2604,28874,0.64416,0,2,862050,859446,2604
6696801,132.859,54.5824,2688,1460,0.64739,0,2,862134,859446,2688
6696801,132.752,47.7596,2820,5840,0.647717,0,2,862266,859446,2820
6696801,129.658,41.7897,2928,7300,0.658002,0,2,862374,859446,2928
6696801,134.451,36.566,3096,8760,0.664502,0,2,862542,859446,3096
6696801,125.144,31.9952,3156,10220,0.682689,0,2,862602,859446,3156
6733301,115.501,356.246,578,11680,0.698603,0,2,862650,862072,578
6733301,123.564,311.715,758,13140,0.717528,0,2,862830,862072,758
6733301,129.118,272.751,926,13140,0.736587,0,2,862998,862072,926
6733301,126.478,238.657,1034,13140,0.755763,0,2,863106,862072,1034
6733301,131.669,208.825,1202,13140,0.782543,0,2,863274,862072,1202
6765421,196.874,188.821,1272,14600,0.99034,0,2,869202,867930,1272
6772721,192.267,316.556,1332,14600,0.99726,0,2,871890,870558,1332
6772721,222.816,142.069,2808,1460,0.99377,0,2,873366,870558,2808
6772721,225.676,95.1749,3504,8760,0.994577,0,2,874062,870558,3504
6791701,213.966,419.278,948,10220,0.979005,0,2,874194,873246,948
6794621,200.72,390.118,870,5840,0.952879,0,2,874302,873432,870
6796081,208.63,364.604,948,5840,0.915019,0,2,874566,873618,948
6797541,205.052,342.278,942,5840,0.866892,0,2,874746,873804,942
6812141,188.42,322.743,828,5840,0.82228,0,2,874818,873990,828
6817981,179.868,305.65,762,5840,0.778245,0,2,874938,874176,762
6820901,202.384,316.194,732,5840,0.737215,0,2,875298,874566,732
6823821,217.586,323.17,684,20899,0.711313,0,2,875622,874938,684
6826741,236.888,329.024,686,20280,0.696149,0,2,875994,875308,686
6828201,257.777,333.896,722,19741,0.70038,0,2,876398,875676,722
6829661,255.555,315.159,778,21201,0.719083,0,2,876638,875860,778
6831121,249.11,298.764,798,22026,0.745447,0,2,876842,876044,798
6832581,244.972,284.418,830,21867,0.776016,0,2,877058,876228,830
6844261,224.307,92.6308,2544,8760,0.949275,0,2,879985,877441,2544
6857401,237.91,318.469,1189,11680,0.974735,0,2,881497,880308,1189
6879301,213.96,276.801,1440,13140,0.987354,0,2,884437,882997,1440
6880761,215.018,150.437,2220,10220,0.990034,0,2,885961,883741,2220
6889521,225.048,409.14,927,10220,0.984277,0,2,887401,886474,927
6889521,234.417,357.998,1227,5840,0.983743,0,2,887701,886474,1227
6889521,227.615,313.248,1407,5840,0.963275,0,2,887881,886474,1407
6889521,226.163,274.092,1623,5840,0.929115,0,2,888097,886474,1623
6892441,346.393,555.33,287,17520,0.812976,0,1,889285,888998,287
6904121,316.594,503.914,251,18980,0.722604,0,1,889393,889142,251
6907041,315.394,458.925,414,20440,0.641029,0,1,889700,889286,414
6909961,314.97,437.559,438,23360,0.58465,0,1,890012,889574,438
6912881,317.599,418.864,486,22446,0.545319,0,1,890348,889862,486
6915801,318.399,402.506,522,21534,0.530904,0,2,890672,890150,522
6918721,322.099,388.193,582,20824,0.540791,0,2,891020,890438,582
6920181,329.337,375.669,674,23277,0.581942,0,2,891400,890726,674
6934781,218.43,294.734,1020,11680,0.931781,0,2,894416,893396,1020
6958141,237.99,439.302,1070,10220,0.992232,0,2,900116,899046,1070
6958141,234.791,197.157,2462,16997,0.981514,0,2,901508,899046,2462
6958141,235.442,172.512,2702,5840,0.977575,0,2,901748,899046,2702
6958141,236.51,132.08,3182,18809,0.979081,0,2,902228,899046,3182
6975661,269.947,471.07,842,18809,0.972946,0,2,902732,901890,842
6990261,255.703,434.686,818,18809,0.970077,0,2,902888,902070,818
7035521,230.934,181.696,1884,11680,0.992023,0,2,909860,907976,1884
7044281,226.538,193.945,1694,8760,0.98767,0,2,911204,909510,1694
7044281,228.221,169.702,1934,8760,0.986711,0,2,911444,909510,1934
7069101,242.344,288.521,1195,5840,0.993573,0,2,914488,913293,1195
7074941,257.596,290.801,1092,19961,0.989983,0,2,915580,914488,1092
7077861,248.396,282.951,1048,19961,0.983735,0,2,915764,914716,1048
7080781,265.347,293.832,1062,16772,0.974518,0,2,916148,915086,1062
7083701,271.178,303.353,1004,16772,0.971453,0,2,916460,915456,1004
7108521,249.743,177.811,2076,10220,0.992021,0,2,921476,919400,2076
7108521,248.525,155.584,2316,11680,0.991769,0,2,921716,919400,2316
7120201,238.066,137.986,2368,17520,0.997092,0,2,924560,922192,2368
7146481,261.002,319.828,1104,18370,0.996831,0,2,927340,926236,1104
7147941,258.376,304.849,1144,19164,0.989727,0,2,927580,926436,1144
7149401,239.94,130.933,2508,8760,0.989716,0,2,929144,926636,2508
7166921,193.959,122.15,2015,10220,0.997362,0,2,932000,929985,2015
7166921,199.714,106.881,2255,10220,0.986442,0,2,932240,929985,2255
7201961,222.614,116.099,2662,20440,0.989579,0,2,938012,935350,2662
7215101,275.111,353.898,1052,24820,0.988019,0,2,939236,938184,1052
7215101,270.722,309.661,1292,26280,0.978266,0,2,939476,938184,1292
7215101,216.354,93.102,2936,5840,0.988466,0,2,941120,938184,2936
7220941,219.31,377.464,808,7300,0.988657,0,2,941360,940552,808
7258901,152.263,255.751,924,17520,0.99079,0,2,945572,944648,924
7264741,163.23,248.782,964,18980,0.984441,0,2,945812,944848,964
7264741,187.174,97.6959,2380,1460,0.99264,0,2,947228,944848,2380
7295401,204.897,95.3248,2700,5840,0.994866,0,2,953300,950600,2700
7323141,209.281,164.641,2016,17520,0.984689,0,2,957596,955580,2016
7323141,214.621,144.061,2268,1460,0.979103,0,2,957848,955580,2268
7343581,300.262,201.441,2469,5840,0.983717,0,2,960476,958007,2469
7365481,267.316,320.148,1368,11680,0.99213,0,2,964736,963368,1368
7365481,263.901,280.13,1608,11680,0.986864,0,2,964976,963368,1608
7369861,277.757,439.056,769,8760,0.989512,0,2,966500,965731,769
7422421,245.724,136.707,2614,1460,0.983675,0,2,973880,971266,2614
7422421,242.008,119.618,2830,23360,0.976966,0,2,974096,971266,2830
7472061,187.686,87.3085,2585,14600,0.988469,0,2,981074,978489,2585
7476441,193.665,358.231,900,11680,0.993575,0,2,982267,981367,900
7512941,178.182,94.8364,2490,1460,0.9973,0,2,986940,984450,2490
7539221,171.425,75.9083,2642,27740,0.997256,0,2,989964,987322,2642
7566961,187.91,87.9257,2457,1460,0.98713,0,2,992916,990459,2457
7590321,206.987,116.662,2326,14600,0.983263,0,2,995952,993626,2326
7612221,254.569,31.046,5286,17520,0.99488,0,2,1003668,998382,5286
7664781,196.428,164.124,2047,11680,0.989646,0,2,1007868,1005821,2047
7664781,201.875,143.608,2287,13140,0.98094,0,2,1008108,1005821,2287
7680841,180.694,106.508,2467,1460,0.9965,0,2,1010952,1008485,2467
7702741,244.48,39.8661,4521,16060,0.988538,0,2,1015548,1011027,4521
7715881,195.176,572.111,1044,5840,0.982804,0,2,1017164,1016120,1044
7715881,199.279,500.597,1272,5840,0.972453,0,2,1017392,1016120,1272
7715881,199.869,438.023,1476,5840,0.968397,0,2,1017596,1016120,1476
7715881,197.385,383.27,1656,5840,0.971097,0,2,1017776,1016120,1656
7746541,224.512,168.29,2580,20440,0.989597,0,2,1021124,1018544,2580
7746541,238.448,147.253,2916,1460,0.975897,0,2,1021460,1018544,2916
7746541,225.142,128.847,3048,5840,0.97141,0,2,1021592,1018544,3048
7746541,219.499,112.741,3228,7300,0.973734,0,2,1021772,1018544,3228
7809321,220.285,160.233,2613,1460,0.99614,0,2,1030472,1027859,2613
7809321,221.25,140.204,2841,5840,0.994122,0,2,1030700,1027859,2841
7829761,233.528,331.075,1029,23360,0.986112,0,2,1032125,1031096,1029
7831221,232.837,306.316,1124,21914,0.985348,0,2,1032353,1031229,1124
7831221,207.232,268.026,1152,21914,0.98468,0,2,1032381,1031229,1152
7844361,195.158,121.498,2220,8760,0.995137,0,2,1034878,1032658,2220
7844361,199.263,106.311,2448,1460,0.989495,0,2,1035106,1032658,2448
7861881,187.719,173.241,1490,13140,0.995592,0,2,1036738,1035248,1490
7895461,250.458,407.502,1208,16060,0.993594,0,2,1042194,1040986,1208
7895461,218.848,160.024,2544,8760,0.978734,0,2,1043530,1040986,2544
7898381,221.492,353.021,1080,1460,0.973892,0,2,1043770,1042690,1080
7915901,218.649,127.44,2356,10220,0.991649,0,2,1046614,1044258,2356
7915901,236.884,22.46,5428,18980,0.996028,0,2,1049686,1044258,5428
7965541,203.562,98.7952,2858,5840,0.997417,0,2,1055585,1052727,2858
8002041,193.114,96.9918,2778,5840,0.991209,0,2,1061592,1058814,2778
8002041,198.975,84.8679,3018,7300,0.991058,0,2,1061832,1058814,3018
8032701,183.412,228.211,1035,18980,0.990677,0,2,1063164,1062129,1035
8042921,159.863,187.418,1476,23360,0.997006,0,2,1066536,1065060,1476
8047301,158.811,158.674,1634,43800,0.998397,0,2,1069128,1067494,1634
8047301,168.96,138.84,1874,45260,0.991097,0,2,1069368,1067494,1874
8047301,156.769,41.7432,3206,13140,0.996073,0,2,1070700,1067494,3206
8060441,167.173,329.025,1106,14600,0.992814,0,2,1070940,1069834,1106
8060441,196.106,57.9875,3590,10220,0.994983,0,2,1073424,1069834,3590
8060441,190.196,7.82447,6614,13140,0.993073,0,2,1076448,1069834,6614
8060441,193.421,6.84641,6830,14600,0.985189,0,2,1076664,1069834,6830
8060441,227.269,0.808336,10190,28990,0.993251,0,2,1080024,1069834,10190
8060441,219.422,0.31743,11690,5840,0.99485,0,2,1081524,1069834,11690
8188921,204.215,255.27,2496,10220,0.990642,0,2,1084772,1082276,2496
8188921,207.188,223.361,2724,1460,0.989312,0,2,1085000,1082276,2724
8210821,156.516,70.8606,2702,5840,0.99301,0,2,1088108,1085406,2702
8237101,188.053,76.6926,2604,13140,0.993028,0,2,1091288,1088684,2604
8241481,228.256,138.594,2640,1460,0.994846,0,2,1094168,1091528,2640
8277981,200.808,136.918,2056,17520,0.983141,0,2,1097024,1094968,2056
8277981,205.707,119.803,2296,16060,0.983999,0,2,1097264,1094968,2296
8277981,186.348,47.0462,3436,11680,0.967466,0,2,1098404,1094968,3436
8291121,190.054,360.29,1099,13140,0.935283,0,2,1098620,1097521,1099
8291121,190.297,315.254,1291,14600,0.919623,0,2,1098812,1097521,1291
8291121,186.01,275.847,1447,16060,0.90592,0,2,1098968,1097521,1447
8291121,186.759,241.366,1639,17520,0.90143,0,2,1099160,1097521,1639
8291121,184.414,211.196,1807,18980,0.895001,0,2,1099328,1097521,1807
8291121,168.862,184.796,1867,20440,0.884376,0,2,1099388,1097521,1867
8291121,156.754,161.697,1939,21900,0.880079,0,2,1099460,1097521,1939
8291121,146.16,141.485,2011,23360,0.878819,0,2,1099532,1097521,2011
8291121,136.89,123.799,2083,24820,0.875217,0,2,1099604,1097521,2083
8291121,127.279,108.324,2143,26280,0.874565,0,2,1099664,1097521,2143
8291121,124.869,94.7836,2251,27740,0.881494,0,2,1099772,1097521,2251
8291121,127.26,82.9357,2395,29200,0.892557,0,2,1099916,1097521,2395
8291121,130.853,72.5687,2551,1460,0.899738,0,2,1100072,1097521,2551
8337841,225.993,499.946,1380,5840,0.998123,0,2,1106564,1105184,1380
8368501,181.506,96.6774,2676,27740,0.99358,0,2,1111220,1108544,2676
8397701,207.189,5.38134,6176,8760,0.982469,0,2,1117832,1111656,6176
8397701,211.291,4.70867,6416,10220,0.973411,0,2,1118072,1111656,6416
8466321,320.862,425.399,2661,1460,0.99589,0,2,1125612,1122951,2661
8486761,256.007,437.791,885,13140,0.992136,0,2,1127136,1126251,885
8498441,220.79,125.314,2373,1460,0.995037,0,2,1130328,1127955,2373
8514501,228.044,96.4058,3197,10220,0.991735,0,2,1133496,1130299,3197
8578741,216.347,152.898,2617,5840,0.987496,0,2,1146756,1144139,2617
8578741,219.304,133.785,2857,5840,0.977809,0,2,1146996,1144139,2857
8578741,208.437,18.0522,5845,10220,0.987006,0,2,1149984,1144139,5845
8578741,210.883,15.7957,6073,11680,0.98613,0,2,1150212,1144139,6073
8578741,213.84,0.220189,12916,24820,0.998557,0,2,1157055,1144139,12916
8697601,268.297,183.258,2334,7300,0.99873,0,2,1176956,1174622,2334
8712201,239.002,271.505,1201,11680,0.998314,0,2,1178732,1177531,1201
8725341,228.757,214.326,1845,5840,0.988453,0,2,1181648,1179803,1845
8748701,256.386,633.555,1131,10220,0.996137,0,2,1185800,1184669,1131
8763301,252.062,331.53,1103,18444,0.992972,0,2,1188892,1187789,1103
8773521,249.066,275.943,1139,16646,0.99474,0,2,1190608,1189469,1139
8782281,269.15,288.904,1075,20792,0.982302,0,2,1192048,1190973,1075
8792501,257.026,261.736,1121,22193,0.990807,0,2,1193500,1192379,1121
8793961,251.898,253.769,1139,22193,0.981956,0,2,1193716,1192577,1139
8820241,241.248,300.282,1112,18980,0.997501,0,2,1198012,1196900,1112
8821701,220.17,112.408,2524,1460,0.992891,0,2,1199612,1197088,2524
8837761,216.203,111.211,2864,8760,0.996247,0,2,1202384,1199520,2864
8852361,234.973,301.937,1108,14600,0.992066,0,2,1203856,1202748,1108
8853821,235.601,289.695,1144,16060,0.981808,0,2,1204096,1202952,1144
8853821,211.151,253.483,1184,17520,0.979082,0,2,1204136,1202952,1184
8875721,209.183,143.369,2068,13140,0.994983,0,2,1208312,1206244,2068
8884481,225.754,200.798,1649,10220,0.990249,0,2,1209721,1208072,1649
8888861,261.593,182.949,2155,14600,0.995818,0,2,1212397,1210242,2155
8888861,261.019,160.08,2412,1460,0.993841,0,2,1212654,1210242,2412
8909301,233.633,300.839,1086,13140,0.987236,0,2,1213950,1212864,1086
8916601,316.284,320.287,1303,20440,0.993738,0,2,1216566,1215263,1303
8916601,250.224,33.0884,5340,8760,0.998103,0,2,1220603,1215263,5340
8916601,272.326,7.61666,8393,23360,0.994563,0,2,1223656,1215263,8393
8916601,280.583,2.00376,11258,14600,0.99482,0,2,1226521,1215263,11258
8916601,286.063,0.786868,13286,24105,0.996716,0,2,1228549,1215263,13286
9004201,473.134,1549.56,831,10220,0.99849,0,2,1236687,1235856,831
9048001,275.406,278.715,1380,18560,0.998703,0,2,1244353,1242973,1380
9048001,283.983,213.391,2004,18560,0.997757,0,2,1244977,1242973,2004
9062601,333.434,397.415,1246,11680,0.995479,0,2,1247762,1246516,1246
9087421,318.978,593.926,1181,10220,0.995976,0,2,1254102,1252921,1181
9088881,260.474,248.211,2458,8760,0.99592,0,2,1255646,1253188,2458
9104941,278.242,363.747,994,10220,0.997348,0,2,1257902,1256908,994
9113701,291.893,323.097,1070,15757,0.99631,0,2,1259718,1258648,1070
9139981,256.457,120.722,2558,8760,0.9961,0,2,1266194,1263636,2558
9176481,249.502,242.769,1500,10220,0.996092,0,2,1272142,1270642,1500
9215901,241.297,149.733,1944,8760,0.996144,0,2,1279450,1277506,1944
9239261,238.871,257.047,1131,18980,0.994405,0,2,1282566,1281435,1131
9240721,217.905,111.937,2319,7300,0.987803,0,2,1283950,1281631,2319
9250941,220.667,306.82,888,1460,0.988078,0,2,1284190,1283302,888
9258241,200.753,236.096,1151,13140,0.985318,0,2,1285510,1284359,1151
9258241,205.659,206.584,1391,13140,0.985903,0,2,1285750,1284359,1391
9284521,269.226,269.444,1128,24694,0.991848,0,2,1290006,1288878,1128
9285981,264.072,254.514,1206,24694,0.985367,0,2,1290234,1289028,1206
9285981,236.063,222.7,1246,24694,0.985946,0,2,1290274,1289028,1246
9285981,215.556,87.4532,2677,1460,0.991981,0,2,1291705,1289028,2677
9304961,223.331,134.026,2528,1460,0.994837,0,2,1294597,1292069,2528
9319561,211.9,228.995,1377,11680,0.996722,0,2,1296037,1294660,1377
9319561,233.131,102.772,2889,7300,0.987279,0,2,1297549,1294660,2889
9354601,227.623,122.637,2304,8760,0.985798,0,2,1303525,1301221,2304
9407161,210.498,114.763,2219,10220,0.984911,0,2,1312222,1310003,2219
9407161,214.186,100.418,2459,10220,0.984297,0,2,1312462,1310003,2459
9427601,206.979,262.255,982,13140,0.989604,0,2,1314082,1313100,982
9434901,230.093,252.246,1084,18980,0.992656,0,2,1315174,1314090,1084
9436361,254.831,270.215,1116,21014,0.982324,0,2,1315602,1314486,1116
9437821,251.477,261.188,1146,21014,0.983284,0,2,1315830,1314684,1146
9437821,223.543,228.54,1174,21014,0.984123,0,2,1315858,1314684,1174
9437821,221.587,174.976,1606,21014,0.984094,0,2,1316290,1314684,1606
9437821,217.653,133.966,2014,5840,0.984072,0,2,1316698,1314684,2014
9437821,215.946,117.22,2218,5840,0.982313,0,2,1316902,1314684,2218
9437821,212.953,102.567,2410,1460,0.983274,0,2,1317094,1314684,2410
9449501,187.834,290.497,816,5840,0.984115,0,2,1317106,1316290,816
9471401,245.758,249.551,1154,20073,0.996607,0,2,1321218,1320064,1154
9484541,239.061,78.1896,3492,10220,0.994732,0,2,1325470,1321978,3492
9484541,256.843,40.1041,4869,14600,0.986048,0,2,1326847,1321978,4869
9507901,234.866,495.221,1407,11680,0.993271,0,2,1328395,1326988,1407
9513741,277.404,458.477,1133,16060,0.983556,0,2,1329747,1328614,1133
9515201,271.229,428.918,1139,5840,0.973111,0,2,1329975,1328836,1139
9516661,267.325,403.053,1157,5840,0.968972,0,2,1330215,1329058,1157
9573601,230.72,240.451,1197,21900,0.99858,0,2,1339423,1338226,1197
9576521,217.035,299.549,1008,1460,0.996942,0,2,1340875,1339867,1008
9589661,199.658,218.047,1243,13140,0.986449,0,2,1342399,1341156,1243
9589661,204.701,190.791,1483,13140,0.986893,0,2,1342639,1341156,1483
9589661,198.724,146.074,1843,5840,0.988715,0,2,1342999,1341156,1843
9589661,188.884,127.815,1963,5840,0.986376,0,2,1343119,1341156,1963
9589661,184.773,111.838,2119,5840,0.986829,0,2,1343275,1341156,2119
9589661,187.177,97.8583,2323,5840,0.987225,0,2,1343479,1341156,2323
9626161,194.488,75.4691,2771,1460,0.994734,0,2,1349431,1346660,2771
9667041,211.593,249.875,1263,16060,0.989681,0,2,1353811,1352548,1263
9667041,191.763,85.8592,2727,5840,0.995204,0,2,1355275,1352548,2727
9667041,196.293,75.1268,2955,7300,0.984554,0,2,1355503,1352548,2955
9699161,195.619,298.004,768,5840,0.990904,0,2,1358803,1358035,768
9734201,249.26,321.937,1234,11680,0.998031,0,2,1363447,1362213,1234
9734201,217.846,144.484,2362,18980,0.995366,0,2,1364575,1362213,2362
9754641,207.857,315.632,1026,13140,0.994658,0,2,1366219,1365193,1026
9756101,216.975,163.966,2046,8760,0.986352,0,2,1367587,1365541,2046
9775081,211.1,128.4,2214,5840,0.995395,0,2,1370599,1368385,2214
9775081,211.713,112.35,2430,17520,0.987221,0,2,1370815,1368385,2430
9788221,265.042,320.62,1066,21900,0.991259,0,2,1372167,1371101,1066
9791141,225.321,22.6972,4988,16060,0.990721,0,2,1376443,1371455,4988
9843701,212.056,348.069,888,7300,0.997124,0,2,1381111,1380223,888
9851001,250.904,295.49,1144,14600,0.996209,0,2,1382835,1381691,1144
9851001,223.041,258.554,1172,16060,0.992933,0,2,1382863,1381691,1172
9851001,213.349,116.038,2396,8760,0.993078,0,2,1384087,1381691,2396
9851001,213.68,101.533,2612,1460,0.985194,0,2,1384303,1381691,2612
9868521,195.652,242.188,1468,11680,0.991686,0,2,1385575,1384107,1468
9872901,196.074,294.881,996,1460,0.99625,0,2,1387339,1386343,996
9897721,249.896,267.226,1168,5840,0.990387,0,2,1390155,1388987,1168
9907941,207.928,98.2091,2364,13140,0.991018,0,2,1393123,1390759,2364
9919621,210.437,283.933,1008,1460,0.96964,0,2,1393351,1392343,1008
9919621,211.132,248.441,1224,5840,0.964685,0,2,1393567,1392343,1224
9919621,208.741,217.386,1416,7300,0.96785,0,2,1393759,1392343,1416
9940061,207.717,106.118,2283,8760,0.994594,0,2,1397587,1395304,2283
9940061,208.752,92.8532,2499,10220,0.98527,0,2,1397803,1395304,2499
9966341,217.74,321.715,1290,11680,0.990512,0,2,1400827,1399537,1290
9985321,282.386,350.813,1163,25780,0.992504,0,2,1403727,1402564,1163
9988241,226.584,168.449,1955,10220,0.993306,0,2,1405043,1403088,1955
9988241,228.261,147.393,2195,11680,0.987893,0,2,1405283,1403088,2195
9997001,193.382,143.32,1896,16060,0.993996,0,2,1406507,1404611,1896
10018901,170.879,194.244,1595,14600,0.997541,0,2,1408463,1406868,1595
10035201,195.489,20.24,4410,16060,0.99247,0,2,1415037,1410627,4410
10039581,187.467,622.46,1099,13140,0.988986,0,2,1416657,1415558,1099
10096521,371.266,501.545,1176,23857,0.987754,0,2,1422521,1421345,1176
10096521,329.858,438.851,1216,23857,0.973035,0,2,1422561,1421345,1216
10096521,318.626,383.995,1456,23857,0.967656,0,2,1422801,1421345,1456
10096521,301.298,335.996,1636,23857,0.970449,0,2,1422981,1421345,1636
10096521,272.868,257.247,1996,7300,0.976125,0,2,1423341,1421345,1996
10099441,233.402,376.835,828,10220,0.982755,0,2,1423809,1422981,828
10128641,266.027,286.605,1120,23176,0.992963,0,2,1426577,1425457,1120
10147621,225.792,124.238,2863,7300,0.998324,0,2,1430949,1428086,2863
10163681,247.25,297.773,1189,14600,0.990498,0,2,1432529,1431340,1189
10165141,221.688,49.929,3831,11680,0.983535,0,2,1435353,1431522,3831
10165141,223.977,43.6879,4071,11680,0.975593,0,2,1435593,1431522,4071
10165141,234.98,38.2269,4383,11680,0.969894,0,2,1435905,1431522,4383
10197261,262.31,545.212,1110,21751,0.98682,0,2,1438745,1437635,1110
10208941,295.258,441.444,1086,21383,0.98449,0,2,1440305,1439219,1086
10252741,225.12,188.632,1812,11680,0.993639,0,2,1448709,1446897,1812
10252741,226.98,165.053,2052,13140,0.965684,0,2,1448949,1446897,2052
10252741,227.108,144.421,2280,1460,0.948724,0,2,1449177,1446897,2280
10252741,224.219,126.368,2484,5840,0.943883,0,2,1449381,1446897,2484
10260041,208.192,328.822,834,7300,0.942148,0,2,1449477,1448643,834
10260041,207.668,287.72,1038,8760,0.945629,0,2,1449681,1448643,1038
10260041,201.209,251.755,1194,10220,0.951176,0,2,1449837,1448643,1194
10260041,186.558,220.285,1278,11680,0.956029,0,2,1449921,1448643,1278
10274641,199.36,101.313,2232,10220,0.984751,0,2,1452633,1450401,2232
10286321,187.746,149.447,1824,13140,0.98726,0,2,1453989,1452165,1824
10328661,213.008,122.656,2512,10220,0.99867,0,2,1463195,1460683,2512
10346181,224.816,263.586,1206,11680,0.994318,0,2,1464359,1463153,1206
10346181,222.214,230.638,1410,11680,0.988778,0,2,1464563,1463153,1410
10346181,171.592,69.3431,2730,7300,0.991626,0,2,1465883,1463153,2730
10359321,177.143,304.425,996,8760,0.987673,0,2,1466099,1465103,996
10379761,214.829,238.237,1270,23360,0.984147,0,2,1470263,1468993,1270
10403121,218.076,262.149,1082,14600,0.990055,0,2,1473227,1472145,1082
10403121,224.051,102.945,2678,5840,0.983595,0,2,1474823,1472145,2678
10423561,203.686,274.753,960,16060,0.976863,0,2,1476371,1475411,960
10425021,228.725,261.409,1196,17520,0.978505,0,2,1476775,1475579,1196
10425021,186.634,175.124,1488,21900,0.98435,0,2,1477067,1475579,1488
10442541,229.231,7.42609,6516,11680,0.998583,0,2,1484075,1477559,6516
10442541,223.077,6.49783,6696,11680,0.99626,0,2,1484255,1477559,6696
10442541,227.892,0.671282,10932,8760,0.998364,0,2,1488491,1477559,10932
10442541,174.042,0.176598,12528,23360,0.99332,0,2,1490087,1477559,12528
10442541,176.286,0.154523,12720,24820,0.985405,0,2,1490279,1477559,12720
10442541,175.251,0.135208,12888,26280,0.983479,0,2,1490447,1477559,12888
10442541,216.144,0.00321534,18672,25486,0.998357,0,2,1496231,1477559,18672
10575561,828.388,2527.73,891,7300,0.988318,0,2,1503612,1502721,891
10577021,770.84,2252.27,935,10220,0.988528,0,2,1503980,1503045,935
10607681,360.305,581.231,1093,18643,0.994481,0,2,1508029,1506936,1093
10609141,343.767,536.202,1100,18643,0.993921,0,2,1508257,1507157,1100
10628121,280.736,312.096,1191,21881,0.987351,0,2,1511089,1509898,1191
10628121,249.144,273.084,1219,21881,0.980182,0,2,1511117,1509898,1219
10644181,219.787,256.223,1518,11680,0.994007,0,2,1513901,1512383,1518
10654401,251.558,296.269,1065,5840,0.98981,0,2,1515608,1514543,1065
10655861,248.614,286.236,1077,5840,0.979834,0,2,1515836,1514759,1077
10657321,244.537,277.456,1077,5840,0.971105,0,2,1516052,1514975,1077
10658781,263.47,294.899,1056,5840,0.968467,0,2,1516448,1515392,1056
10663161,248.532,277.907,1012,22325,0.974607,0,2,1516848,1515836,1012
10671921,308.856,325.84,1028,22002,0.970489,0,2,1518168,1517140,1028
10673381,317.749,328.36,1062,24334,0.960428,0,2,1518548,1517486,1062
10676301,295.03,308.94,1025,24334,0.959124,0,2,1518684,1517659,1025
10679221,291.152,313.573,943,24334,0.952984,0,2,1518948,1518005,943
10682141,292.258,314.626,921,24147,0.942611,0,2,1519248,1518327,921
10685061,294.725,312.548,935,25240,0.933534,0,2,1519560,1518625,935
10687981,295.385,310.729,937,25529,0.925593,0,2,1519860,1518923,937
10690901,291.462,309.138,903,25373,0.926144,0,2,1520124,1519221,903
10704041,244.113,13.484,6556,13140,0.994494,0,2,1527140,1520584,6556
10704041,256.424,6.91609,7924,20440,0.995926,0,2,1528508,1520584,7924
10739081,296.911,1256.94,739,5840,0.990178,0,2,1531364,1530625,739
10750761,289.797,1128.08,753,5840,0.962656,0,2,1531604,1530851,753
10759521,283.572,1015.32,767,5840,0.951074,0,2,1531844,1531077,767
10762441,284.126,916.652,829,5840,0.94094,0,2,1532132,1531303,829
10765361,274.11,830.321,807,5840,0.929572,0,2,1532336,1531529,807
10766821,284.346,754.781,937,17702,0.927126,0,2,1532692,1531755,937
10768281,275.803,688.683,927,17624,0.927485,0,2,1532908,1531981,927
10769741,272.828,630.848,953,17534,0.932799,0,2,1533160,1532207,953
10771201,268.724,580.242,967,17495,0.932449,0,2,1533400,1532433,967
10772661,263.634,535.961,969,17495,0.939643,0,2,1533628,1532659,969
10774121,257.679,497.216,959,17495,0.943438,0,2,1533844,1532885,959
10775581,258.47,463.314,997,17482,0.946758,0,2,1534108,1533111,997
10777041,256.161,433.65,1011,17482,0.944663,0,2,1534348,1533337,1011
10778501,249.641,407.694,989,17482,0.94283,0,2,1534552,1533563,989
10779961,248.436,384.982,1003,16077,0.943727,0,2,1534792,1533789,1003
10807701,238.772,98.9189,2719,1460,0.983967,0,2,1540724,1538005,2719
10823761,242.256,133.272,2900,7300,0.995521,0,2,1543544,1540644,2900
10823761,240.474,116.613,3128,8760,0.992331,0,2,1543772,1540644,3128
10823761,230.601,59.8118,4232,5840,0.992316,0,2,1544876,1540644,4232
10836901,416.276,696.835,792,1460,0.957027,0,2,1546592,1545800,792
10839821,470.741,708.731,852,16060,0.933648,0,2,1547444,1546592,852
10841281,463.899,672.64,848,18980,0.910692,0,2,1547860,1547012,848
10842741,432.911,614.81,854,20440,0.893106,0,2,1548076,1547222,854
10844201,408.797,564.208,884,21718,0.892718,0,2,1548316,1547432,884
10847121,380.698,519.932,858,21538,0.899878,0,2,1548500,1547642,858
10857341,259.734,157.431,2370,10220,0.962334,0,2,1551356,1548986,2370
10860261,257.267,342.502,972,1460,0.955792,0,2,1551596,1550624,972
10874861,239.803,270.835,1188,13140,0.98014,0,2,1553204,1552016,1188
10888001,278.421,347.648,1174,10220,0.992928,0,2,1556260,1555086,1174
10888001,248.618,304.192,1214,11680,0.990062,0,2,1556300,1555086,1214
10888001,255.351,156.023,2534,7300,0.992403,0,2,1557620,1555086,2534
10904061,253.308,416.65,1101,10220,0.992353,0,2,1558880,1557779,1101
10904061,251.645,364.569,1341,11680,0.984559,0,2,1559120,1557779,1341
10906981,282.791,403.78,1023,5840,0.959428,0,2,1559896,1558873,1023
10908441,286.442,383.307,1095,5840,0.91325,0,2,1560208,1559113,1095
10911361,276.637,358.394,1119,16060,0.867843,0,2,1560416,1559297,1119
10912821,289.557,388.469,900,18980,0.810613,0,2,1560796,1559896,900
10915741,270.362,378.911,724,20440,0.760536,0,2,1560932,1560208,724
10918661,277.067,377.547,680,20804,0.714219,0,2,1561256,1560576,680
10921581,285.934,376.354,660,23105,0.683692,0,2,1561604,1560944,660
10924501,292.192,375.309,628,22534,0.67698,0,2,1561940,1561312,628
10927421,297.668,365.146,670,21962,0.681108,0,2,1562276,1561606,670
10930341,309.959,356.252,772,21550,0.707219,0,2,1562672,1561900,772
10942021,253.152,138.029,2305,11680,0.928855,0,2,1565528,1563223,2305
10942021,251.508,120.776,2545,13140,0.925248,0,2,1565768,1563223,2545
10944941,241.249,165.748,2698,18752,0.981826,0,2,1568864,1566166,2698
10981441,214.527,371.8,972,13140,0.982863,0,2,1570256,1569284,972
10990201,225.696,121.851,2662,5840,0.990298,0,2,1573196,1570534,2662
10994581,223.236,315.636,1092,5840,0.971322,0,2,1573628,1572536,1092
10996041,223.831,300.182,1128,5840,0.936157,0,2,1573856,1572728,1128
10997501,276.853,403.659,648,5840,0.857887,0,2,1574504,1573856,648
10998961,294.746,434.202,420,26280,0.784401,0,1,1574924,1574504,420
11004801,266.903,393.051,387,26280,0.725101,0,2,1574996,1574609,387
11007721,247.04,357.045,390,26280,0.670714,0,1,1575104,1574714,390
11007721,229.66,312.414,498,26280,0.633124,0,2,1575212,1574714,498
11007721,215.952,273.363,618,1460,0.602734,0,2,1575332,1574714,618
11007721,203.958,239.192,738,5840,0.578642,0,2,1575452,1574714,738
11007721,185.964,209.293,798,7300,0.570062,0,2,1575512,1574714,798
11007721,165.718,183.132,822,8760,0.560054,0,2,1575536,1574714,822
11009181,166.003,225.865,465,10220,0.558797,0,2,1575704,1575239,465
11009181,151.253,197.632,513,11680,0.557698,0,2,1575752,1575239,513
11010641,145.846,190.928,477,11680,0.561735,0,2,1575860,1575383,477
11015021,142.616,180.187,492,13140,0.565269,0,2,1575980,1575488,492
11023781,141.289,170.789,519,14600,0.57586,0,2,1576112,1575593,519
11026701,149.128,159.94,639,16060,0.597627,0,2,1576316,1575677,639
11029621,154.487,160.948,663,18980,0.626674,0,2,1576508,1575845,663
11032541,160.676,161.829,699,21900,0.65709,0,2,1576712,1576013,699
11035461,169.091,162.6,759,24820,0.696204,0,2,1576940,1576181,759
11055901,250.977,120.33,2773,1460,0.984314,0,2,1582664,1579891,2773
11088021,223.035,56.6529,3768,8760,0.993914,0,2,1586972,1583204,3768
11090941,225.155,419.446,1049,10220,0.992175,0,2,1587212,1586163,1049
11090941,225.511,367.015,1277,11680,0.989403,0,2,1587440,1586163,1277
11090941,220.282,280.996,1673,5840,0.978137,0,2,1587836,1586163,1673
11090941,222.747,245.872,1913,5840,0.95712,0,2,1588076,1586163,1913
11090941,208.403,215.138,2021,5840,0.93623,0,2,1588184,1586163,2021
11090941,191.353,188.246,2093,5840,0.915451,0,2,1588256,1586163,2093
11104081,320.434,508.715,565,18980,0.87227,0,2,1589480,1588915,565
11118681,301.38,466.875,559,20440,0.834486,0,2,1589648,1589089,559
11121601,308.707,430.266,745,21900,0.801425,0,2,1590008,1589263,745
11124521,307.619,419.983,697,23598,0.779997,0,2,1590308,1589611,697
11127441,308.166,402.235,731,20532,0.778747,0,2,1590620,1589889,731
11130361,305.646,386.706,741,20238,0.782654,0,2,1590908,1590167,741
11131821,316.44,373.117,855,21592,0.806072,0,2,1591300,1590445,855
11168321,223.543,49.4975,3958,13140,0.990037,0,2,1600026,1596068,3958
11168321,265.939,22.2143,5686,18980,0.985529,0,2,1601754,1596068,5686
11168321,262.697,19.4375,5926,20440,0.981088,0,2,1601994,1596068,5926
11232561,623.371,1324.81,657,20440,0.964982,0,2,1616862,1616205,657
11235481,569.45,1187.33,624,17620,0.930609,0,2,1617054,1616430,624
11273441,527.893,1067.04,636,17620,0.903033,0,2,1617291,1616655,636
11274901,516.907,961.785,851,17620,0.866404,0,2,1617731,1616880,851
11276361,479.293,869.687,842,17413,0.839353,0,2,1617947,1617105,842
11277821,447.882,789.101,845,17219,0.820684,0,2,1618175,1617330,845
11279281,420.397,718.588,848,17051,0.806849,0,2,1618403,1617555,848
11280741,393.347,656.89,827,16908,0.797243,0,2,1618607,1617780,827
11282201,372.679,602.903,830,16753,0.796337,0,2,1618835,1618005,830
11283661,359.094,555.666,869,16624,0.800545,0,2,1619099,1618230,869
11285121,344.207,514.332,884,16572,0.816727,0,2,1619339,1618455,884
11298261,222.953,148.78,2028,7300,0.967987,0,2,1622283,1620255,2028
11298261,223.584,130.182,2256,7300,0.961989,0,2,1622511,1620255,2256
11323081,269.751,344.444,1138,17520,0.99,0,2,1625495,1624357,1138
11324541,264.532,318.888,1226,18980,0.98875,0,2,1625723,1624497,1226
11324541,197.464,109.573,2490,17520,0.993634,0,2,1626987,1624497,2490
11324541,192.348,37.6502,3990,13140,0.990313,0,2,1628487,1624497,3990
11324541,197.119,14.7851,5370,5840,0.976196,0,2,1629867,1624497,5370
11324541,200.979,12.9369,5598,5840,0.942921,0,2,1630095,1624497,5598
11324541,204.356,11.3198,5826,5840,0.907556,0,2,1630323,1624497,5826
11330381,277.812,762.405,598,23360,0.870362,0,2,1631115,1630517,598
11343521,255.085,680.229,589,24820,0.840316,0,2,1631211,1630622,589
11362501,238.2,608.326,604,26280,0.819027,0,2,1631331,1630727,604
11365421,233.925,545.41,703,27740,0.802899,0,2,1631535,1630832,703
11368341,233.184,503.484,721,30660,0.783786,0,2,1631763,1631042,721
11371261,231.036,466.798,727,23177,0.777063,0,2,1631979,1631252,727
11374181,230.657,434.698,745,25194,0.78368,0,2,1632207,1631462,745
11377101,228.825,406.611,751,24652,0.79947,0,2,1632423,1631672,751
11390241,236.936,134.578,2474,11680,0.95336,0,2,1635495,1633021,2474
11399001,243.886,179.909,2332,16060,0.984264,0,2,1638387,1636055,2332
11417981,232.346,169.164,2392,18980,0.98558,0,2,1641135,1638743,2392
11434041,194.888,356.501,1140,13140,0.991295,0,2,1642611,1641471,1140
11434041,200.527,311.939,1380,13140,0.986133,0,2,1642851,1641471,1380
11434041,242.173,208.975,2364,5840,0.96946,0,2,1643835,1641471,2364
11438421,321.402,514.353,588,1460,0.897028,0,2,1644711,1644123,588
11444261,339.726,523.559,468,15816,0.813649,0,1,1645179,1644711,468
11450101,321.261,491.114,396,15816,0.743193,0,1,1645371,1644975,396
11451561,336.103,462.725,572,15816,0.674044,0,1,1645811,1645239,572
11453021,328.59,437.884,584,15241,0.616039,0,1,1646087,1645503,584
11454481,317.516,416.149,560,14754,0.565284,0,1,1646327,1645767,560
11455941,307.827,397.13,536,14301,0.523373,0,1,1646567,1646031,536
11457401,303.848,380.489,548,13869,0.491702,0,1,1646843,1646295,548
11458861,298.867,365.928,548,13504,0.468989,0,2,1647107,1646559,548
11460321,300.509,353.187,596,13184,0.464115,0,2,1647419,1646823,596
11461781,300.445,342.038,632,12973,0.477351,0,2,1647719,1647087,632
11463241,300.39,332.284,668,12841,0.521432,0,2,1648019,1647351,668
11477841,291.673,275.339,1093,15694,0.86035,0,2,1651031,1649938,1093
11509961,263.932,294.637,1108,13432,0.985585,0,2,1656971,1655863,1108
11511421,259.441,288.307,1092,13432,0.986136,0,2,1657199,1656107,1092
11518721,257.568,266.726,1132,5840,0.987889,0,2,1658459,1657327,1132
11520181,255.372,257.76,1177,5840,0.951903,0,2,1658699,1657522,1177
11521641,253.451,249.915,1222,5840,0.915415,0,2,1658939,1657717,1222
11521641,226.769,218.676,1262,5840,0.883488,0,2,1658979,1657717,1262
11521641,259.923,191.341,1754,5840,0.844302,0,2,1659471,1657717,1754
11521641,246.933,167.423,1910,17440,0.810014,0,2,1659627,1657717,1910
11521641,237.066,146.496,2078,4380,0.777513,0,2,1659795,1657717,2078
11521641,240.433,128.184,2342,4380,0.739074,0,2,1660059,1657717,2342
11530401,228.379,350.911,576,5840,0.700439,0,2,1660203,1659627,576
11531861,244.331,328.047,764,17483,0.676634,0,2,1660559,1659795,764
11533321,240.79,320.041,716,18943,0.658305,0,2,1660775,1660059,716
11534781,239.191,310.536,700,19936,0.652267,0,2,1661003,1660303,700
11536241,245.292,302.219,744,19470,0.666984,0,2,1661291,1660547,744
11537701,244.631,294.941,740,19536,0.684861,0,2,1661531,1660791,740
11539161,244.052,282.449,785,19226,0.715503,0,2,1661771,1660986,785
11549381,225.775,115.882,2147,7300,0.938947,0,2,1664463,1662316,2147
11549381,227.553,101.397,2387,7300,0.942829,0,2,1664703,1662316,2387
11596101,224.38,159.569,2249,5840,0.971703,0,2,1672527,1670278,2249
11596101,226.332,139.623,2489,5840,0.93399,0,2,1672767,1670278,2489
11596101,223.541,122.17,2693,5840,0.885991,0,2,1672971,1670278,2693
11596101,252.598,106.899,3149,1460,0.821492,0,2,1673427,1670278,3149
11607781,261.523,466.162,492,18980,0.755056,0,1,1673751,1673259,492
11612161,245.333,428.891,456,20440,0.694424,0,1,1673883,1673427,456
11615081,247.666,395.28,560,21900,0.636371,0,1,1674147,1673587,560
11618001,252.708,385.87,528,23615,0.588075,0,1,1674435,1673907,528
11620921,266.12,377.636,568,22520,0.555815,0,2,1674795,1674227,568
11623841,268.855,370.432,536,21662,0.532588,0,2,1675083,1674547,536
11626761,286.248,364.128,624,20323,0.519765,0,2,1675491,1674867,624
11629681,292.467,358.612,640,19810,0.523544,0,2,1675827,1675187,640
11632601,302.408,355.035,682,19403,0.556851,0,2,1676199,1675517,682
11634061,315.107,351.906,756,19138,0.593495,0,2,1676603,1675847,756
11645741,252.982,127.155,2368,10220,0.916873,0,2,1679535,1677167,2368
11645741,251.359,111.26,2608,10220,0.922264,0,2,1679775,1677167,2608
11672021,244.219,204.068,1872,13140,0.988219,0,2,1684227,1682355,1872
11682241,235.509,236.375,1991,5840,0.978877,0,2,1687011,1685020,1991
11682241,236.071,206.828,2231,5840,0.936517,0,2,1687251,1685020,2231
11685161,335.562,524.474,515,16060,0.883203,0,2,1688283,1687768,515
11698301,313.117,478.915,511,17520,0.836552,0,2,1688439,1687928,511
11701221,287.477,439.051,459,18980,0.795733,0,2,1688547,1688088,459
11702681,300.542,404.169,691,20440,0.767517,0,2,1688939,1688248,691
11705601,284.475,373.648,703,21242,0.745327,0,2,1689111,1688408,703
11708521,287.915,366.942,695,20841,0.740911,0,2,1689423,1688728,695
11709981,303.926,361.074,791,20476,0.744547,0,2,1689839,1689048,791
11712901,287.435,335.94,803,20366,0.760229,0,2,1690011,1689208,803
11715821,299.506,333.948,867,20311,0.78645,0,2,1690395,1689528,867
11718741,307.068,332.204,907,20311,0.811894,0,2,1690755,1689848,907
11728961,235.147,117.109,2351,8760,0.955862,0,2,1693479,1691128,2351
11728961,234.253,102.47,2579,10220,0.955129,0,2,1693707,1691128,2579
11740641,211.842,409.71,1155,11680,0.978332,0,2,1695279,1694124,1155
11740641,226.678,183.876,2595,18980,0.987776,0,2,1696719,1694124,2595
11740641,223.685,82.5226,3927,10220,0.975764,0,2,1698051,1694124,3927
11740641,225.725,72.2073,4167,11680,0.976293,0,2,1698291,1694124,4167
11740641,235.91,16.6215,6747,24820,0.980793,0,2,1700871,1694124,6747
11740641,236.421,14.5438,6987,26280,0.959444,0,2,1701111,1694124,6987
11761081,235.369,818.976,765,27740,0.950763,0,2,1701339,1700574,765
11781521,231.448,734.104,829,28719,0.935668,0,2,1701543,1700714,829
11784441,208.517,656.341,765,28719,0.922459,0,2,1701591,1700826,765
11785901,198.952,588.298,785,25799,0.903402,0,2,1701723,1700938,785
11791741,186.083,528.761,769,25799,0.879227,0,2,1701819,1701050,769
11794661,176.323,476.666,765,25799,0.860573,0,2,1701927,1701162,765
11797581,181.282,431.083,869,25799,0.835502,0,2,1702143,1701274,869
11800501,181.122,405.197,825,25507,0.808564,0,2,1702323,1701498,825
11803421,192.982,391.798,803,25131,0.773744,0,2,1702599,1701796,803
11806341,202.109,377.823,789,24756,0.735776,0,2,1702865,1702076,789
11809261,203.845,365.595,725,24381,0.706304,0,2,1703081,1702356,725
11812181,208.365,354.896,685,23901,0.678016,0,2,1703321,1702636,685
11812321,223.944,345.534,738,23359,0.667014,0,2,1703654,1702916,738
11815241,246.701,357.467,703,23025,0.686137,0,2,1704060,1703357,703
11816701,260.364,347.784,779,22649,0.72412,0,2,1704416,1703637,779
11828381,243.264,128.808,2400,10220,0.927745,0,2,1707157,1704757,2400
11828381,242.856,112.707,2640,11680,0.926777,0,2,1707397,1704757,2640
11844441,214.166,67.1579,3512,10220,0.991708,0,2,1711645,1708133,3512
11857581,215.464,46.2543,4472,5840,0.992893,0,2,1715269,1710797,4472
11857581,211.031,40.4725,4652,5840,0.970032,0,2,1715449,1710797,4652
11878021,450.152,820.913,492,21900,0.932528,0,2,1717573,1717081,492
11880941,411.883,732.924,519,23360,0.912212,0,2,1717717,1717198,519
11882401,378.398,655.934,546,24820,0.904435,0,2,1717861,1717315,546
11895541,352.098,588.567,597,26280,0.912631,0,2,1718029,1717432,597
11907221,259.843,173.701,2409,14600,0.957388,0,2,1720729,1718320,2409
11907221,257.363,151.988,2649,14600,0.942715,0,2,1720969,1718320,2649
11907221,255.192,132.99,2889,14600,0.946126,0,2,1721209,1718320,2889
11920361,243.087,80.5501,3843,11680,0.988184,0,2,1725505,1721662,3843
11929121,259.767,591.521,1500,5840,0.974428,0,2,1729213,1727713,1500
11929121,266.296,517.581,1812,5840,0.930124,0,2,1729525,1727713,1812
11929121,257.009,452.883,2004,5840,0.875109,0,2,1729717,1727713,2004
11964161,353.883,723.773,416,1460,0.79947,0,1,1730749,1730333,416
11965621,384.147,685.301,596,17769,0.753286,0,2,1731345,1730749,596
11967081,369.129,627.389,638,17150,0.717876,0,2,1731609,1730971,638
11968541,352.988,576.715,656,16677,0.691891,0,2,1731849,1731193,656
11970001,338.864,532.376,674,18137,0.689155,0,2,1732089,1731415,674
11971461,331.006,493.579,728,18913,0.69426,0,2,1732365,1731637,728
11972921,318.131,459.631,734,18729,0.711228,0,2,1732593,1731859,734
11974381,311.364,424.302,821,18584,0.738574,0,2,1732857,1732036,821
11986061,230.928,128.114,2265,13140,0.947676,0,2,1735717,1733452,2265
11986061,224.703,10.1333,6597,7300,0.994611,0,2,1740049,1733452,6597
12026941,251.705,529.161,1137,13140,0.993486,0,2,1741377,1740240,1137
12028401,250.242,487.391,1182,14600,0.99305,0,2,1741617,1740435,1182
12028401,222.01,191.397,2554,5840,0.986021,0,2,1742989,1740435,2554
12031321,224.259,383.222,1068,5840,0.972768,0,2,1743229,1742161,1068
12031321,226.226,335.319,1308,5840,0.942422,0,2,1743469,1742161,1308
12031321,212.948,293.404,1428,5840,0.905869,0,2,1743589,1742161,1428
12031321,255.329,256.729,1980,5840,0.853886,0,2,1744141,1742161,1980
12031321,241.413,224.638,2124,17547,0.8109,0,2,1744285,1742161,2124
12031321,259.237,196.558,2508,17547,0.775788,0,2,1744669,1742161,2508
12031321,255.332,171.988,2736,17547,0.752564,0,2,1744897,1742161,2736
12031321,253.416,150.49,2976,1460,0.744744,0,2,1745137,1742161,2976
12031321,251.739,131.678,3216,5840,0.752901,0,2,1745377,1742161,3216
12053221,241.271,464.094,593,7300,0.770038,0,2,1745545,1744952,593
12061981,231.253,133.07,2377,8760,0.950722,0,2,1748641,1746264,2377
12073661,246.651,388.253,996,10220,0.975384,0,2,1750225,1749229,996
12073661,244.973,199.138,2208,16060,0.986124,0,2,1751437,1749229,2208
12073661,242.851,174.246,2436,17520,0.980359,0,2,1751665,1749229,2436
12107241,286.384,355.918,1209,10220,0.980471,0,2,1756185,1754976,1209
12108701,280.586,332.428,1281,11680,0.967912,0,2,1756425,1755144,1281
12108701,247.513,290.875,1297,13140,0.959423,0,2,1756441,1755144,1297
12108701,243.574,254.515,1513,14600,0.940745,0,2,1756657,1755144,1513
12108701,235.627,222.701,1693,5840,0.911902,0,2,1756837,1755144,1693
12108701,227.174,194.863,1861,5840,0.876664,0,2,1757005,1755144,1861
12108701,218.277,170.505,2017,5840,0.835831,0,2,1757161,1755144,2017
12108701,208.992,149.192,2161,4380,0.792602,0,2,1757305,1755144,2161
12113081,206.868,342.168,660,4380,0.749777,0,2,1757497,1756837,660
12120381,209.51,339.897,564,14600,0.704805,0,2,1757725,1757161,564
12121841,230.821,327.41,704,18018,0.647954,0,1,1758105,1757401,704
12124761,226.468,316.484,660,17458,0.59571,0,1,1758301,1757641,660
12126221,247.16,336.923,572,16899,0.559996,0,2,1758693,1758121,572
12127681,247.765,324.808,584,16278,0.541247,0,2,1758945,1758361,584
12129141,249.794,314.207,608,15755,0.529841,0,2,1759209,1758601,608
12130601,251.57,304.931,632,15329,0.532361,0,2,1759473,1758841,632
12132061,257.624,296.815,692,14988,0.547066,0,2,1759773,1759081,692
12133521,261.421,289.713,740,14782,0.579932,0,2,1760061,1759321,740
12134981,264.743,283.499,788,14672,0.621191,0,2,1760349,1759561,788
12136441,266.15,278.061,824,14660,0.664792,0,2,1760625,1759801,824
12149581,296.515,279.328,1091,16120,0.88357,0,2,1763052,1761961,1091
12151041,287.951,274.412,1079,17580,0.896873,0,2,1763280,1762201,1079
12152501,279.082,270.111,1056,17580,0.908514,0,2,1763497,1762441,1056
12162721,265.055,246.211,1188,18892,0.956442,0,2,1765021,1763833,1188
12162721,226.553,84.6004,2776,1460,0.982533,0,2,1766609,1763833,2776
12193381,259.153,331.502,1179,5840,0.948421,0,2,1771009,1769830,1179
12193381,231.759,290.064,1219,5840,0.913618,0,2,1771049,1769830,1219
12193381,228.289,253.806,1423,5840,0.873166,0,2,1771253,1769830,1423
12193381,250.753,222.08,1831,16060,0.82277,0,2,1771661,1769830,1831
12193381,237.409,194.32,1975,7300,0.776174,0,2,1771805,1769830,1975
12193381,219.733,170.03,2071,7300,0.740402,0,2,1771901,1769830,2071
12193381,202.766,148.776,2155,8760,0.709102,0,2,1771985,1769830,2155
12193381,193.92,130.179,2287,10220,0.691714,0,2,1772117,1769830,2287
12205061,177.18,342.782,516,11680,0.6715,0,2,1772177,1771661,516
12207981,189.533,317.934,648,27210,0.668813,0,2,1772453,1771805,648
12210901,203.341,310.192,692,30130,0.668961,0,2,1772753,1772061,692
12213821,215.424,303.418,736,30190,0.691591,0,2,1773053,1772317,736
12229881,208.79,409.984,1111,11680,0.971155,0,2,1777505,1776394,1111
12279521,199.568,350.62,1299,13140,0.991814,0,2,1783469,1782170,1299
12279521,204.622,306.793,1539,13140,0.991587,0,2,1783709,1782170,1539
12279521,196.799,205.527,2091,5840,0.985614,0,2,1784261,1782170,2091
12279521,178.199,179.836,2139,5840,0.976162,0,2,1784309,1782170,2139
12279521,173.924,157.357,2283,5840,0.960392,0,2,1784453,1782170,2283
12279521,170.184,137.687,2427,5840,0.936593,0,2,1784597,1782170,2427
12283901,262.911,466.976,567,24820,0.863269,0,2,1785509,1784942,567
12286821,239.047,423.604,519,26280,0.80411,0,2,1785581,1785062,519
12301421,222.666,385.654,507,27740,0.754847,0,2,1785689,1785182,507
12304341,223.333,352.447,615,28493,0.709241,0,2,1785917,1785302,615
12307261,222.416,338.391,591,27495,0.666836,0,2,1786133,1785542,591
12310181,224.614,326.092,591,26546,0.637231,0,2,1786373,1785782,591
12313101,226.537,315.331,591,25719,0.626327,0,2,1786613,1786022,591
12316021,232.72,305.914,627,24989,0.624286,0,2,1786889,1786262,627
12318941,241.13,297.675,687,24454,0.640001,0,2,1787189,1786502,687
12321861,245.489,290.466,723,24186,0.671251,0,2,1787465,1786742,723
12335001,222.195,104.412,2367,11680,0.931284,0,2,1790309,1787942,2367
12335001,222.921,91.3602,2595,13140,0.918624,0,2,1790537,1787942,2595
12351061,190.439,130.33,2396,23360,0.981642,0,2,1793444,1791048,2396
12351061,149.849,34.2865,3764,16060,0.988921,0,2,1794812,1791048,3764
12351061,167.118,30.0007,4052,17520,0.966555,0,2,1795100,1791048,4052
12351061,167.228,26.2506,4220,17520,0.969486,0,2,1795268,1791048,4220
12351061,228.887,6.04266,6933,5840,0.961726,0,2,1797981,1791048,6933
12370041,225.776,746.162,1210,5840,0.92776,0,2,1798185,1796975,1210
12370041,223.054,652.892,1414,5840,0.87804,0,2,1798389,1796975,1414
12370041,207.172,571.281,1510,5840,0.823285,0,2,1798485,1796975,1510
1554121,237.058,71.3426,3732,7300,0.979093,0,2,52276,48544,3732
1554121,237.425,62.4247,3972,8760,0.972957,0,2,52516,48544,3972
1554121,236.247,54.6216,4200,10220,0.973837,0,2,52744,48544,4200
1554121,233.716,47.7939,4416,5840,0.972107,0,2,52960,48544,4416
1554121,224.002,41.8197,4572,5840,0.971844,0,2,53116,48544,4572
1554121,215.502,36.5922,4728,5840,0.966614,0,2,53272,48544,4728
1554121,212.564,32.0182,4920,5840,0.945787,0,2,53464,48544,4920
1578941,541.993,947.391,413,1460,0.850064,0,1,56312,55899,413
1581861,531.994,880.592,462,16024,0.745056,0,1,56774,56312,462
1584781,497.62,810.518,399,18944,0.653174,0,1,57031,56632,399
1587701,474.792,749.203,394,19527,0.571527,0,1,57346,56952,394
1590621,455.443,695.553,394,18632,0.502586,0,1,57666,57272,394
1593541,438.513,648.609,394,17848,0.443513,0,1,57986,57592,394
1596461,424.199,607.533,398,17172,0.388074,0,1,58310,57912,398
1599381,412.299,571.591,407,16588,0.340814,0,1,58639,58232,407
1599521,402.762,540.142,423,16096,0.298213,0,1,58975,58552,423
1602441,850.291,973.124,402,15694,0.272186,0,1,62958,62556,402
1605361,790.505,891.484,454,15311,0.264413,0,1,63330,62876,454
1606821,740.692,820.048,526,10372,0.282611,0,2,63722,63196,526
1608281,675.105,737.542,582,11832,0.311035,0,2,63938,63356,582
1609741,631.217,681.1,620,13292,0.360905,0,2,64262,63642,620
1619961,320.692,203.654,2162,7300,0.847525,0,2,67326,65164,2162
1619961,310.606,178.198,2402,8760,0.835335,0,2,67566,65164,2402
1619961,301.78,155.923,2642,10220,0.844668,0,2,67806,65164,2642
1643321,292.303,360.484,1105,11010,0.960494,0,2,70934,69829,1105
1644781,285.765,347.549,1088,12470,0.960432,0,2,71174,70086,1088
1655001,265.132,275.724,1206,13930,0.983212,0,2,72938,71732,1206
1655001,235.398,123.744,2410,5840,0.971216,0,2,74142,71732,2410
1655001,235.973,108.276,2650,5840,0.912314,0,2,74382,71732,2650
1655001,236.476,94.7413,2890,1460,0.864524,0,2,74622,71732,2890
1655001,230.917,82.8986,3082,5840,0.807709,0,2,74814,71732,3082
1655001,226.052,72.5363,3274,5840,0.750495,0,2,75006,71732,3274
1671061,215.796,423.594,537,15390,0.697933,0,2,75150,74613,537
1671061,211.321,370.645,717,16850,0.634442,0,1,75330,74613,717
1672521,227.906,384.314,581,16850,0.558886,0,1,75674,75093,581
1675441,225.418,366.275,549,16966,0.490276,0,1,75882,75333,549
1676901,247.741,380.491,473,16299,0.442741,0,1,76286,75813,473
1678361,245.773,362.929,465,15596,0.396149,0,1,76518,76053,465
1679821,248.051,347.563,489,14965,0.36038,0,1,76782,76293,489
1681281,245.545,334.118,477,14456,0.331582,0,1,77010,76533,477
1682741,247.852,322.353,501,13995,0.311385,0,1,77274,76773,501
1684201,248.37,312.059,513,15455,0.293712,0,1,77526,77013,513
1685661,250.324,303.052,537,16236,0.290748,0,1,77790,77253,537
1687121,247.534,295.17,525,16006,0.290654,0,1,78018,77493,525
1690041,245.592,282.274,565,15787,0.295572,0,2,78250,77685,565
1691501,266.893,294.99,597,15654,0.304876,0,2,78666,78069,597
1692961,262.031,282.116,633,15581,0.313016,0,2,78894,78261,633
1695881,255.277,270.851,649,15581,0.325139,0,2,79102,78453,649
1698801,271.368,284.995,649,16405,0.348247,0,2,79486,78837,649
1701721,289.947,297.371,685,17028,0.380966,0,2,79906,79221,685
1703181,302.703,303.949,727,17028,0.424595,0,2,80298,79571,727
1706101,289.365,286.456,759,17028,0.472771,0,2,80494,79735,759
1709021,298.195,291.649,791,17028,0.522425,0,2,80854,80063,791
1730921,239.098,71.2263,3516,8760,0.976797,0,2,87022,83506,3516
1730921,236.101,16.3957,6072,5840,0.974659,0,2,89578,83506,6072
1730921,235.089,14.3462,6300,5840,0.944077,0,2,89806,83506,6300
1763041,312.203,823.678,663,17028,0.899817,0,2,90658,89995,663
1764501,323.677,749.218,839,16226,0.85859,0,2,91062,90223,839
1767421,307.718,684.066,807,16162,0.827516,0,2,91258,90451,807
1768881,324.253,655.558,791,16059,0.802827,0,2,91698,90907,791
1770341,313.721,602.113,803,15944,0.783723,0,2,91938,91135,803
1771801,303.006,555.349,803,17404,0.774508,0,2,92166,91363,803
1773261,295.13,514.43,815,18697,0.766444,0,2,92406,91591,815
1774721,289.739,478.626,839,18646,0.774389,0,2,92658,91819,839
1776181,282.022,447.298,839,18646,0.79134,0,2,92886,92047,839
1779101,269.769,414.136,841,18646,0.816173,0,2,93070,92229,841
1789321,224.798,139.659,2217,8760,0.961724,0,2,95902,93685,2217
1799541,241.75,12.5397,7370,5840,0.970783,0,2,103846,96476,7370
1849181,661.283,952.323,1088,17199,0.985638,0,2,111654,110566,1088
1850641,607.123,861.783,1088,17199,0.986183,0,2,111882,110794,1088
1892981,226.935,174.074,1675,19649,0.989748,0,2,119110,117435,1675
1892981,222.568,152.314,1867,7300,0.97228,0,2,119302,117435,1867
1892981,221.747,133.275,2083,7300,0.939495,0,2,119518,117435,2083
1892981,215.029,116.616,2251,7300,0.900808,0,2,119686,117435,2251
1892981,204.65,102.039,2383,8760,0.864457,0,2,119818,117435,2383
1904661,191.069,298.659,804,10220,0.82765,0,2,119914,119110,804
1907581,200.185,285.327,876,5840,0.787944,0,2,120178,119302,876
1910501,218.662,304.161,788,8760,0.758201,0,2,120526,119738,788
1913421,236.329,321.141,708,11680,0.739676,0,2,120886,120178,708
1914881,257.288,326.998,744,14600,0.743466,0,2,121290,120546,744
1916341,252.127,309.123,776,5840,0.754283,0,2,121506,120730,776
1917801,246.111,293.483,796,5840,0.768748,0,2,121710,120914,796
1919261,242.347,279.798,828,5840,0.788904,0,2,121926,121098,828
1938241,218.982,152.157,1968,11680,0.982053,0,2,126202,124234,1968
1938241,220.843,68.2875,3312,8760,0.986946,0,2,127546,124234,3312
1970361,278.21,485.001,1156,14052,0.991151,0,2,131934,130778,1156
1971821,273.434,461.126,1102,14052,0.983507,0,2,132174,131072,1102
1973281,269.255,440.235,1048,14052,0.984319,0,2,132414,131366,1048
1974741,265.598,421.956,994,14052,0.985029,0,2,132654,131660,994
1976201,272.898,405.961,1024,5840,0.97565,0,2,132978,131954,1024
1977661,277.786,391.966,1042,5840,0.954944,0,2,133290,132248,1042
1979121,280.563,379.72,1048,5840,0.931826,0,2,133590,132542,1048
1980581,275.492,369.005,994,5840,0.901598,0,2,133830,132836,994
1982041,274.056,359.63,964,15026,0.870148,0,2,134094,133130,964
1983501,272.799,351.426,934,14946,0.84763,0,2,134358,133424,934
1984961,270.199,344.248,892,14847,0.830426,0,2,134610,133718,892
1986421,269.424,337.967,862,14708,0.812873,0,2,134874,134012,862
1987881,270.246,332.471,844,14549,0.802514,0,2,135150,134306,844
1989341,273.965,327.662,850,14380,0.795949,0,2,135450,134600,850
1990801,277.22,323.454,856,14241,0.790206,0,2,135750,134894,856
1992261,280.067,319.772,862,14132,0.79018,0,2,136050,135188,862
1993721,282.559,316.551,868,14043,0.797658,0,2,136350,135482,868
1995181,292.239,313.732,934,13973,0.8067,0,2,136710,135776,934
1996641,290.209,311.266,916,13973,0.819613,0,2,136986,136070,916
1998101,294.433,309.107,946,13973,0.833411,0,2,137310,136364,946
1999561,295.129,307.219,952,13973,0.852985,0,2,137610,136658,952
2015621,263.263,264.522,1024,17344,0.962408,0,2,140562,139538,1024
2017081,260.355,260.832,1029,17431,0.962107,0,2,140802,139773,1029
2025841,251.207,240.766,1130,17518,0.975494,0,2,142254,141124,1130
2041901,255.696,366.207,897,10220,0.991859,0,2,144982,144085,897
2041901,253.734,320.431,1137,11680,0.982877,0,2,145222,144085,1137
2047741,275.486,312.22,1131,15644,0.987463,0,2,146466,145335,1131
2049201,271.05,304.443,1121,5840,0.97778,0,2,146706,145585,1121
2055041,303.114,332.848,1056,5840,0.963864,0,2,147762,146706,1056
2056501,301.225,322.492,1094,17405,0.949631,0,2,148050,146956,1094
2057961,289.072,313.43,1048,17405,0.922177,0,2,148254,147206,1048
2059421,282.938,305.501,1038,17405,0.893155,0,2,148494,147456,1038
2060881,274.57,305.564,948,17405,0.867761,0,2,148710,147762,948
2063801,267.749,298.618,918,17230,0.848041,0,2,148930,148012,918
2065261,292.28,323.791,882,17032,0.828286,0,2,149394,148512,882
2066721,284.245,314.567,860,16799,0.811,0,2,149622,148762,860
2068181,277.215,306.496,838,16565,0.795875,0,2,149850,149012,838
2069641,275.563,299.434,852,16332,0.785141,0,2,150114,149262,852
2071101,271.118,293.255,842,16146,0.778248,0,2,150354,149512,842
2072561,265.728,287.848,820,15971,0.772217,0,2,150582,149762,820
2074021,268.512,283.117,858,15784,0.76944,0,2,150870,150012,858
2075481,266.448,278.977,860,15679,0.77201,0,2,151122,150262,860
2076941,269.142,275.355,898,17139,0.774259,0,2,151410,150512,898
2078401,265.499,272.186,888,18483,0.786226,0,2,151650,150762,888
2091541,231.865,116.074,2172,7300,0.958284,0,2,154834,152662,2172
2111981,268.383,294.613,1086,14600,0.982897,0,2,157734,156648,1086
2113441,263.335,287.662,1075,16034,0.983785,0,2,157962,156887,1075
2130961,252.788,260.467,1063,16034,0.991267,0,2,160818,159755,1063
2132421,251.189,257.783,1064,17494,0.991109,0,2,161058,159994,1064
2139721,243.351,242.634,1093,5840,0.98919,0,2,162234,161141,1093
2141181,242.932,236.18,1142,5840,0.951791,0,2,162474,161332,1142
2142641,241.066,230.532,1179,5840,0.915317,0,2,162702,161523,1179
2142641,215.933,201.716,1219,5840,0.890902,0,2,162742,161523,1219
2142641,250.441,176.501,1711,5840,0.83579,0,2,163234,161523,1711
2142641,240.136,154.439,1879,18088,0.770066,0,2,163402,161523,1879
2142641,228.119,135.134,2023,4380,0.707558,0,1,163546,161523,2023
2142641,223.604,118.242,2215,4380,0.645363,0,1,163738,161523,2215
2151401,206.154,338.337,420,5840,0.585943,0,1,163822,163402,420
2154321,216.384,314.045,564,5840,0.52645,0,1,164110,163546,564
2157241,235.836,333.789,464,8760,0.469394,0,1,164482,164018,464
2160161,258.857,344.191,467,11680,0.424469,0,1,164902,164435,467
2161621,272.5,348.167,459,14600,0.392661,0,1,165270,164811,459
2163081,265.437,328.146,487,16060,0.367328,0,1,165486,164999,487
2164541,260.758,310.628,527,17426,0.357662,0,1,165714,165187,527
2166001,256.663,295.299,567,16913,0.364204,0,2,165942,165375,567
2167461,250.08,281.887,583,16540,0.364929,0,2,166146,165563,583
2168921,247.32,270.151,623,16245,0.375563,0,2,166374,165751,623
2171841,242.405,259.882,643,16059,0.394867,0,2,166582,165939,643
2173301,265.604,274.397,695,15935,0.429259,0,2,167010,166315,695
2174761,260.904,263.597,735,15935,0.474352,0,2,167238,166503,735
2176221,253.791,254.148,751,17395,0.518808,0,2,167442,166691,751
2177681,250.567,245.879,791,18855,0.567707,0,2,167670,166879,791
2189361,232.153,89.2276,2579,13140,0.920063,0,2,170734,168155,2579
2189361,243.86,17.972,5651,14790,0.982649,0,2,173806,168155,5651
2189361,249.338,3.61987,8687,13140,0.984005,0,2,176842,168155,8687
2189361,263.649,2.77146,9299,5840,0.986504,0,2,177454,168155,9299
2189361,253.193,2.42503,9479,5840,0.984441,0,2,177634,168155,9479
2189361,247.044,2.1219,9683,5840,0.965136,0,2,177838,168155,9683
2231701,811.914,1753.11,439,1460,0.880744,0,1,182604,182165,439
2239001,761.424,1588.84,408,16046,0.809401,0,2,183012,182604,408
2240461,719.746,1419.49,602,16046,0.764476,0,2,183440,182838,602
2241921,665.778,1271.3,656,15597,0.740166,0,2,183728,183072,656
2243381,615.556,1141.64,686,15285,0.741396,0,2,183992,183306,686
2244841,574.611,1028.18,740,15060,0.762471,0,2,184280,183540,740
2253601,298.657,262.344,2279,10220,0.938408,0,2,187176,184897,2279
2276961,223.645,150.282,2326,11680,0.991478,0,2,190440,188114,2326
2276961,262.959,34.5936,5266,16060,0.996788,0,2,193380,188114,5266
2276961,252.068,15.5255,6718,5840,0.951059,0,2,194832,188114,6718
2298861,250.559,768.96,915,5840,0.893426,0,2,195072,194157,915
2298861,246.239,672.84,1131,5840,0.840498,0,2,195288,194157,1131
2298861,233.459,588.735,1275,5840,0.784186,0,2,195432,194157,1275
2298861,229.777,515.143,1479,14588,0.734913,0,2,195636,194157,1479
2298861,234.055,450.75,1743,14588,0.681798,0,2,195900,194157,1743
2298861,231.798,394.406,1959,14588,0.640324,0,2,196116,194157,1959
2298861,240.323,345.106,2259,14588,0.601533,0,2,196416,194157,2259
2298861,241.783,301.967,2511,14588,0.572592,0,2,196668,194157,2511
2298861,246.06,264.221,2787,1460,0.552268,0,2,196944,194157,2787
2320761,248.302,555.944,453,5840,0.546984,0,2,197208,196755,453
2322221,278.265,520.951,665,7300,0.562361,0,2,197696,197031,665
2323681,289.982,490.332,761,8760,0.595816,0,2,198068,197307,761
2325141,291.234,463.54,785,10220,0.645089,0,2,198368,197583,785
2338281,297.568,325.385,1105,16884,0.892043,0,2,201116,200011,1105
2339741,287.372,312.212,1101,16884,0.903038,0,2,201332,200231,1101
2349961,267.95,355.778,1313,10220,0.97672,0,2,204384,203071,1313
2349961,258.537,159.671,2813,5840,0.985802,0,2,205884,203071,2813
2371861,229.863,195.86,1859,5840,0.98464,0,2,208614,206755,1859
2371861,231.13,171.377,2099,5840,0.96406,0,2,208854,206755,2099
2371861,229.239,149.955,2315,5840,0.932303,0,2,209070,206755,2315
2371861,223.084,131.211,2495,5840,0.897015,0,2,209250,206755,2495
2377701,199.699,320.184,888,5840,0.863638,0,2,209286,208398,888
2380621,231.736,364.161,672,5840,0.809433,0,2,209742,209070,672
2386461,219.269,341.141,624,18980,0.759504,0,2,209874,209250,624
2389381,217.361,318.499,668,5840,0.708316,0,2,210078,209410,668
2392301,226.191,320.186,624,8760,0.668527,0,2,210366,209742,624
2395221,233.917,322.163,576,11680,0.631211,0,2,210654,210078,576
2398141,249.677,321.893,616,14600,0.606059,0,2,211014,210398,616
2401061,257.467,321.656,608,17520,0.586552,0,2,211326,210718,608
2403981,265.784,321.449,612,20440,0.574483,0,2,211650,211038,612
2406901,267.061,313.268,632,22702,0.573923,0,2,211926,211294,632
2409821,269.678,306.109,664,22319,0.575932,0,2,212214,211550,664
2412741,271.969,299.846,696,22063,0.582691,0,2,212502,211806,696
2415661,272.473,294.365,716,21917,0.593604,0,2,212778,212062,716
2418581,274.413,289.569,748,23668,0.615654,0,2,213066,212318,748
2421501,274.612,285.373,768,23668,0.647447,0,2,213342,212574,768
2424421,274.785,281.702,788,23668,0.682766,0,2,213618,212830,788
2439021,228.059,106.308,2269,13140,0.934854,0,2,216342,214073,2269
2439021,230.177,93.0193,2514,14600,0.937997,0,2,216587,214073,2514
2480841,210.889,141.855,2298,10220,0.98371,0,2,222588,220290,2298
2480841,214.528,124.123,2538,10220,0.978246,0,2,222828,220290,2538
2480841,206.975,83.1525,3126,5840,0.984177,0,2,223416,220290,3126
2480841,212.603,72.7584,3378,7300,0.967404,0,2,223668,220290,3378
2480841,208.527,63.6636,3558,8760,0.935229,0,2,223848,220290,3558
2493981,204.961,409.456,908,10220,0.897075,0,2,224028,223120,908
2496901,194.341,378.774,864,11680,0.863691,0,2,224148,223284,864
2502741,182.049,348.052,827,13140,0.82698,0,2,224244,223417,827
2502741,166.793,304.546,887,14600,0.799857,0,2,224304,223417,887
2502741,159.443,266.477,995,14600,0.781125,0,2,224412,223417,995
2505661,171.013,290.418,789,14600,0.759734,0,2,224664,223875,789
2508581,184.136,302.115,681,17520,0.746018,0,2,224940,224259,681
2511501,189.619,291.351,693,20440,0.731515,0,2,225168,224475,693
2514421,194.417,281.932,705,23360,0.726326,0,2,225396,224691,705
2517341,197.115,273.691,705,26280,0.731785,0,2,225612,224907,705
2520261,203.975,266.479,741,27306,0.744062,0,2,225864,225123,741
2523181,209.979,260.169,777,27090,0.769804,0,2,226116,225339,777
2539241,217.909,292.844,852,14600,0.946135,0,2,228864,228012,852
2540701,219.171,281.738,876,14600,0.949118,0,2,229092,228216,876
2556761,240.577,115.146,2716,1460,0.99415,0,2,233484,230768,2716
2578661,207.052,264.62,1254,16060,0.99674,0,2,234972,233718,1254
2584501,200.835,347.444,883,27289,0.998,0,2,237204,236321,883
2585961,192.23,318.639,898,28749,0.9945,0,2,237336,236438,898
2590341,190.702,293.434,961,30209,0.988937,0,2,237516,236555,961
2600561,186.364,271.38,1000,30209,0.97532,0,2,237672,236672,1000
2603481,170.568,252.082,943,30209,0.962155,0,2,237732,236789,943
2604941,153.747,235.197,862,30209,0.948136,0,2,237768,236906,862
2606401,154.029,220.422,901,30209,0.930869,0,2,237924,237023,901
2607861,139.275,207.495,820,30209,0.91326,0,2,237960,237140,820
2612241,141.366,196.183,859,30209,0.892853,0,2,238116,237257,859
2615161,143.195,183.285,922,27289,0.867496,0,2,238272,237350,922
2618081,143.296,183.624,880,27289,0.845309,0,2,238416,237536,880
2621001,144.884,183.921,850,28792,0.820895,0,2,238572,237722,850
2623921,146.273,184.181,820,30919,0.802033,0,2,238728,237908,820
2626841,142.989,184.408,754,30803,0.775529,0,2,238848,238094,754
2629761,156.616,192.482,757,32637,0.759838,0,2,239100,238343,757
2632681,165.539,196.672,759,32260,0.746108,0,2,239328,238569,759
2635601,164.346,198.338,705,31946,0.744095,0,2,239484,238779,705
2638521,169.303,197.796,715,31443,0.754833,0,2,239688,238973,715
2641441,173.64,196.321,733,31035,0.779229,0,2,239892,239159,733
2644361,172.935,195.031,715,30753,0.805575,0,2,240060,239345,715
2657501,232.183,190.632,1197,30345,0.895278,0,2,241472,240275,1197
2657501,210.826,65.5029,2725,1460,0.951517,0,2,243000,240275,2725
2666261,194.52,32.457,4359,18980,0.991181,0,2,247524,243165,4359
2721741,185.732,230.896,1758,4380,0.998052,0,2,251256,249498,1758
2727581,240.515,397.784,816,4380,0.949546,0,2,251880,251064,816
2727581,235.951,348.061,1020,18497,0.897103,0,2,252084,251064,1020
2727581,255.957,304.553,1416,18497,0.841215,0,2,252480,251064,1416
2727581,235.962,266.484,1512,18497,0.797313,0,2,252576,251064,1512
2727581,224.467,233.174,1656,18497,0.758899,0,2,252720,251064,1656
2727581,218.909,204.027,1836,18497,0.735286,0,2,252900,251064,1836
2737801,215.545,366.774,522,18497,0.707126,0,2,253092,252570,522
2739261,236.102,344.427,714,5840,0.692485,0,2,253472,252758,714
2742181,229.589,324.874,710,7300,0.687174,0,2,253656,252946,710
2743641,254.391,331.264,762,10220,0.685028,0,2,254084,253322,762
2746561,250.092,313.356,794,11680,0.698149,0,2,254304,253510,794
2749481,269.83,321.187,826,14600,0.732131,0,2,254712,253886,826
2759701,230.983,109.321,2388,8760,0.949041,0,2,257712,255324,2388
2791821,231.091,394.886,951,11680,0.987219,0,2,262212,261261,951
2791821,232.204,345.525,1191,13140,0.981317,0,2,262452,261261,1191
2791821,221.062,155.07,2463,15996,0.989115,0,2,263724,261261,2463
2815181,215.695,355.981,966,5840,0.971976,0,2,265224,264258,966
2816641,243.733,355.984,1050,5840,0.921729,0,2,265664,264614,1050
2818101,255.267,357.736,1016,5840,0.872763,0,2,266000,264984,1016
2821021,249.358,343.019,984,17658,0.824917,0,2,266208,265224,984
2822481,256.689,355.891,846,17658,0.773053,0,2,266516,265670,846
2825401,252.102,352.655,736,17632,0.720171,0,2,266736,266000,736
2828321,267.09,364.323,662,17252,0.6739,0,2,267108,266446,662
2829781,285.703,374.533,632,16808,0.643412,0,2,267524,266892,632
2831241,279.991,355.591,649,16363,0.621736,0,2,267764,267115,649
2832701,277.992,339.017,690,15996,0.607769,0,2,268028,267338,690
2834161,273.243,324.515,707,15748,0.598048,0,2,268268,267561,707
2835621,269.087,311.826,724,15565,0.599542,0,2,268508,267784,724
2837081,266.951,300.722,753,15421,0.610849,0,2,268760,268007,753
2838541,262.083,291.007,758,15342,0.623243,0,2,268988,268230,758
2840001,259.322,282.506,775,15290,0.646587,0,2,269228,268453,775
2841461,255.407,275.068,780,15264,0.674514,0,2,269456,268676,780
2842921,256.481,268.559,821,15251,0.71145,0,2,269720,268899,821
2844381,255.921,262.865,850,15251,0.746269,0,2,269972,269122,850
2864821,238.38,194.43,1680,13140,0.969564,0,2,274212,272532,1680
2875041,256.787,309.151,948,8760,0.97759,0,2,275856,274908,948
2892561,267.692,396.924,918,10220,0.989105,0,2,278676,277758,918
2892561,262.731,347.308,1146,11680,0.980467,0,2,278904,277758,1146
2892561,256.56,178.138,2394,5840,0.957481,0,2,280152,277758,2394
2892561,254.49,155.87,2634,1460,0.911546,0,2,280392,277758,2634
2902781,252.679,374.137,972,5840,0.868853,0,2,280632,279660,972
2902781,246.594,327.37,1176,15917,0.831496,0,2,280836,279660,1176
2902781,235.27,286.448,1332,15917,0.806309,0,2,280992,279660,1332
2905701,228.361,365.392,594,15917,0.77177,0,2,281172,280578,594
2905701,228.316,319.718,822,15917,0.749049,0,2,281400,280578,822
2907161,259.276,341.753,802,15917,0.734168,0,2,281876,281074,802
2908621,255.367,330.034,782,15505,0.728647,0,2,282104,281322,782
2910081,256.446,319.78,798,15309,0.733816,0,2,282368,281570,798
2911541,255.89,310.807,802,15159,0.753339,0,2,282620,281818,802
2913001,259.904,302.957,842,15032,0.775422,0,2,282908,282066,842
2927601,272.377,266.142,1108,17906,0.939669,0,2,285704,284596,1108
2939281,239.519,113.389,2442,8760,0.975617,0,2,288756,286314,2442
2958261,246.285,156.925,2546,1460,0.994453,0,2,291960,289414,2546
2969941,245.254,314.921,987,5840,0.994655,0,2,293208,292221,987
2971401,244.597,295.056,1071,5840,0.975323,0,2,293448,292377,1071
2971401,244.022,258.174,1311,5840,0.962158,0,2,293688,292377,1311
2971401,243.52,225.902,1551,5840,0.948138,0,2,293928,292377,1551
2971401,255.08,197.664,1887,5840,0.920871,0,2,294264,292377,1887
2971401,250.195,172.956,2103,17520,0.894512,0,2,294480,292377,2103
2971401,242.92,151.337,2295,18980,0.871448,0,2,294672,292377,2295
2971401,245.555,132.42,2559,20440,0.848767,0,2,294936,292377,2559
2971401,234.361,115.867,2715,1460,0.828921,0,2,295092,292377,2715
2971401,223.066,101.384,2859,5840,0.809056,0,2,295236,292377,2859
2971401,214.683,88.7108,3015,7300,0.794174,0,2,295392,292377,3015
2971401,207.347,77.6219,3171,8760,0.778652,0,2,295548,292377,3171
2988921,188.929,388.919,663,10220,0.772571,0,2,295608,294945,663
2988921,184.813,340.304,819,11680,0.767249,0,2,295764,294945,819
2988921,178.211,297.766,951,11680,0.772593,0,2,295896,294945,951
2988921,175.435,260.545,1107,11680,0.772269,0,2,296052,294945,1107
2991841,195.505,305.977,819,11680,0.781985,0,2,296388,295569,819
2994761,214.567,306.73,855,14600,0.790487,0,2,296736,295881,855
2997681,234.246,307.389,915,17520,0.805426,0,2,297108,296193,915
3042941,218.062,308.04,1256,14600,0.996038,0,2,304596,303340,1256
3042941,224.84,138.247,2648,1460,0.989472,0,2,305988,303340,2648
3061921,223.768,190.01,1944,17520,0.98473,0,2,308256,306312,1944
3061921,219.797,166.258,2136,5840,0.957889,0,2,308448,306312,2136
3061921,216.322,145.476,2328,5840,0.921903,0,2,308640,306312,2328
3061921,207.282,127.292,2472,5840,0.887915,0,2,308784,306312,2472
3061921,184.372,111.38,2496,5840,0.853176,0,2,308808,306312,2496
3061921,177.825,97.4576,2628,23360,0.830279,0,2,308940,306312,2628
3066301,232.097,412.275,624,21093,0.795244,0,2,309552,308928,624
3067761,221.085,384.741,576,21093,0.769588,0,2,309696,309120,576
3075061,211.449,360.148,532,21093,0.74964,0,2,309840,309308,532
3082361,213.518,338.63,572,21093,0.739685,0,2,310068,309496,572
3083821,235.828,319.801,776,21093,0.738474,0,2,310460,309684,776
3085281,231.85,303.326,792,20597,0.732415,0,2,310664,309872,792
3086741,229.869,288.91,820,20194,0.732113,0,2,310880,310060,820
3089661,225.635,276.296,828,19899,0.736849,0,2,311076,310248,828
3091121,246.431,288.759,844,19651,0.744743,0,2,311468,310624,844
3092581,244.127,276.164,884,19465,0.7554,0,2,311696,310812,884
3094041,239.111,265.144,900,19387,0.764725,0,2,311900,311000,900
3096961,234.097,255.501,911,19341,0.772884,0,2,312099,311188,911
3099881,248.335,270.563,883,19325,0.777524,0,2,312447,311564,883
3101341,269.293,283.743,923,19263,0.786583,0,2,312863,311940,923
3104261,258.631,271.775,919,19263,0.79701,0,2,313047,312128,919
3107181,274.303,284.803,927,22183,0.813634,0,2,313431,312504,927
3120321,246.856,121.667,2361,10220,0.957463,0,2,316479,314118,2361
3123241,236.022,175.723,2076,11680,0.977159,0,2,317847,315771,2076
3123241,236.519,153.758,2316,11680,0.977515,0,2,318087,315771,2316
3123241,236.059,69.0058,3744,10220,0.988659,0,2,319515,315771,3744
3123241,245.552,60.38,4056,11680,0.986326,0,2,319827,315771,4056
3158281,241.793,577.227,962,11680,0.990602,0,2,322539,321577,962
3162661,240.069,527.324,1012,5840,0.980527,0,2,322767,321755,1012
3162661,235.56,461.408,1216,5840,0.979211,0,2,322971,321755,1216
3162661,228.615,403.732,1396,5840,0.97306,0,2,323151,321755,1396
3162661,203.038,353.266,1420,5840,0.972677,0,2,323175,321755,1420
3162661,197.159,309.107,1576,4380,0.969843,0,2,323331,321755,1576
3200621,235.76,124.918,2558,10220,0.993122,0,2,330987,328429,2558
3200621,253.174,32.8629,5210,16060,0.994441,0,2,333639,328429,5210
3200621,239.634,14.7487,6590,24764,0.995005,0,2,335019,328429,6590
3212301,238.18,741.28,991,24764,0.983129,0,2,335247,334256,991
3272161,221.644,256.312,1235,32120,0.980468,0,2,339935,338700,1235
3272161,198.939,224.273,1275,33580,0.971659,0,2,339975,338700,1275
3272161,188.26,17.739,4323,14600,0.996508,0,2,343023,338700,4323
3272161,210.878,7.96118,5679,23360,0.995933,0,2,344379,338700,5679
3279461,190.512,580.736,1143,14600,0.993603,0,2,345831,344688,1143
3279461,175.613,152.777,2775,1460,0.987067,0,2,347463,344688,2775
3279461,182.161,133.68,3003,5840,0.987434,0,2,347691,344688,3003
3346621,156.21,258.649,972,20440,0.990444,0,2,349059,348087,972
3346621,166.684,226.318,1212,21900,0.990389,0,2,349299,348087,1212
3353921,113.385,29.3252,2825,1460,0.994701,0,2,353469,350644,2825
3423321,130.284,144.357,1694,20440,0.993654,0,2,357849,356155,1694
3423321,143.999,126.312,1934,21900,0.990697,0,2,358089,356155,1934
3423321,179.053,64.7867,3050,8760,0.990228,0,2,359205,356155,3050
3426241,185.171,366.813,797,10220,0.9852,0,2,359433,358636,797
3426241,190.525,320.962,1025,11680,0.98455,0,2,359661,358636,1025
3483181,219.953,234.598,1280,16060,0.992285,0,2,365765,364485,1280
3517961,238.625,338.538,956,13140,0.988567,0,2,371587,370631,956
3517961,238.797,296.22,1196,14600,0.984996,0,2,371827,370631,1196
3539861,294.981,383.547,1091,14600,0.988606,0,2,375483,374392,1091
3541321,288.108,371.354,1045,15570,0.97253,0,2,375723,374678,1045
3548621,288.628,329.779,1055,15457,0.98091,0,2,377163,376108,1055
3555921,295.411,308.455,1113,15427,0.987709,0,2,378651,377538,1113
3563221,288.835,297.517,1063,18347,0.989946,0,2,380031,378968,1063
3573441,260.322,259.104,1095,18949,0.987302,0,2,381723,380628,1095
3589501,229.494,253.166,1188,11680,0.991512,0,2,384607,383419,1188
3599721,206.475,108.366,2207,8760,0.993504,0,2,387451,385244,2207
3599721,209.165,94.8206,2435,10220,0.985566,0,2,387679,385244,2435
3624541,241.754,312.853,1153,17520,0.989593,0,2,390435,389282,1153
3655201,282.721,662.635,937,10220,0.985767,0,2,396259,395322,937
3663961,321.364,528.956,1083,18980,0.979157,0,2,397749,396666,1083
3665421,311.194,486.836,1131,20440,0.979263,0,2,397989,396858,1131
3665421,213.828,167.281,2383,11680,0.990374,0,2,399241,396858,2383
3668341,215.599,346.746,1008,1460,0.980328,0,2,399469,398461,1008
3668341,215.506,265.477,1440,7300,0.981188,0,2,399901,398461,1440
3668341,214.067,232.293,1644,8760,0.97479,0,2,400105,398461,1644
3668341,191.809,203.256,1680,10220,0.969191,0,2,400141,398461,1680
3680021,189.083,303.849,842,10220,0.963042,0,2,400311,399469,842
3681481,188.198,287.243,853,11680,0.945162,0,2,400493,399640,853
3687321,187.173,272.713,862,13140,0.915767,0,2,400673,399811,862
3687321,178.026,238.624,976,14600,0.880046,0,2,400787,399811,976
3690241,194.773,251.546,946,14600,0.81879,0,2,401099,400153,946
3693161,197.176,262.852,818,17520,0.748941,0,1,401313,400495,818
3696081,198.029,272.746,680,20440,0.680324,0,1,401517,400837,680
3699001,202.401,281.403,571,22087,0.609033,0,1,401750,401179,571
3699281,215.851,288.977,539,21197,0.536654,0,1,402060,401521,539
3700741,725.369,774.855,655,20342,0.555822,0,2,406352,405697,655
3702201,663.198,699.248,713,19846,0.587595,0,2,406580,405867,713
3703661,608.798,633.092,771,19538,0.620395,0,2,406808,406037,771
3715341,272.03,147.709,2319,8760,0.931461,0,2,409716,407397,2319
3715341,268.026,129.245,2559,10220,0.927528,0,2,409956,407397,2559
3750381,236.371,373.431,878,10220,0.987242,0,2,416568,415690,878
3762061,235.325,348.002,936,11680,0.946337,0,2,416796,415860,936
3764981,235.909,325.752,1006,13140,0.916795,0,2,417036,416030,1006
3764981,225.92,285.033,1162,5840,0.880945,0,2,417192,416030,1162
3764981,203.68,249.404,1210,5840,0.849577,0,2,417240,416030,1210
3764981,185.72,218.228,1270,5840,0.81963,0,2,417300,416030,1270
3764981,174.505,190.95,1366,5840,0.790926,0,2,417396,416030,1366
3764981,161.692,167.081,1438,5840,0.75831,0,2,417468,416030,1438
3764981,153.481,146.196,1534,5840,0.724772,0,2,417564,416030,1534
3776661,333.796,454.921,514,18980,0.710425,0,2,419160,418646,514
3779581,331.071,414.056,698,20440,0.710372,0,2,419472,418774,698
3782501,324.187,394.299,718,23360,0.715326,0,2,419748,419030,718
3785421,319.664,377.012,750,25731,0.74216,0,2,420036,419286,750
3797101,255.854,135.567,2334,13140,0.935647,0,2,422772,420438,2334
3797101,247.873,118.621,2526,13140,0.933692,0,2,422964,420438,2526
3811701,211.007,254.601,1216,13140,0.973466,0,2,424512,423296,1216
3813161,215.76,43.4913,3850,13140,0.99517,0,2,427620,423770,3850
3813161,222.154,10.0113,6574,11680,0.992638,0,2,430344,423770,6574
3813161,224.385,8.75989,6814,13140,0.959808,0,2,430584,423770,6814
3813161,226.337,7.6649,7054,14600,0.934832,0,2,430824,423770,7054
3813161,226.545,6.70679,7282,5840,0.911728,0,2,431052,423770,7282
3813161,214.727,5.86844,7414,5840,0.881512,0,2,431184,423770,7414
3813161,211.886,5.13489,7606,5840,0.847573,0,2,431376,423770,7606
3870101,302.63,499.709,900,10220,0.963994,0,2,438817,437917,900
3870101,294.801,437.245,1140,10220,0.967245,0,2,439057,437917,1140
3899301,283.434,375.097,1138,14600,0.99433,0,2,443121,441983,1138
3900761,278.005,356.71,1150,16060,0.990039,0,2,443361,442211,1150
3902221,258.99,199.666,2078,5840,0.991141,0,2,444517,442439,2078
3902221,256.616,174.708,2318,5840,0.973498,0,2,444757,442439,2318
3910981,261.722,333.479,1044,7300,0.95846,0,2,445309,444265,1044
3910981,262.007,291.794,1308,8760,0.912402,0,2,445573,444265,1308
3910981,263.756,255.32,1584,10220,0.857102,0,2,445849,444265,1584
3910981,232.286,223.405,1596,10220,0.808714,0,2,445861,444265,1596
3910981,225.751,195.479,1776,11680,0.763875,0,2,446041,444265,1776
3910981,209.532,171.045,1872,13140,0.72714,0,2,446137,444265,1872
3910981,202.84,149.664,2028,14600,0.684998,0,2,446293,444265,2028
3922661,202.985,348.456,492,16060,0.645623,0,2,446497,446005,492
3924121,228.112,333.899,664,5840,0.62117,0,2,446901,446237,664
3925581,226.598,318.162,672,7300,0.602274,0,2,447117,446445,672
3927041,223.773,303.766,673,5840,0.58824,0,2,447321,446648,673
3928501,222.802,291.171,686,5840,0.58846,0,2,447537,446851,686
3929961,223.451,280.149,711,5840,0.586152,0,2,447765,447054,711
3931421,222.52,270.506,724,5840,0.589133,0,2,447981,447257,724
3934341,223.705,262.067,753,18081,0.596742,0,2,448213,447460,753
3935801,249.242,280.059,775,19973,0.633399,0,2,448641,447866,775
3938721,244.087,270.427,780,19858,0.670474,0,2,448849,448069,780
3948941,222.605,106.163,2256,8760,0.926128,0,2,451621,449365,2256
3948941,224.78,92.8929,2496,8760,0.914112,0,2,451861,449365,2496
3979601,248.099,318.386,1032,8760,0.982236,0,2,456181,455149,1032
3979601,247.087,278.588,1272,10220,0.981957,0,2,456421,455149,1272
4001501,197.583,277.437,1093,5840,0.980968,0,2,459277,458184,1093
4001501,202.885,242.757,1333,5840,0.929597,0,2,459517,458184,1333
4001501,207.524,212.412,1573,5840,0.869647,0,2,459757,458184,1573
4001501,249.084,185.861,2113,5840,0.787191,0,1,460297,458184,2113
4001501,262.948,162.628,2473,20440,0.700042,0,1,460657,458184,2473
4001501,245.08,142.3,2593,21900,0.618787,0,1,460777,458184,2593
4001501,221.945,124.512,2653,23360,0.552689,0,1,460837,458184,2653
4001501,209.202,108.948,2773,1460,0.492353,0,1,460957,458184,2773
4001501,196.551,95.3297,2881,5840,0.438308,0,1,461065,458184,2881
4017561,182.482,418.289,286,7300,0.39227,0,1,461149,460863,286
4017561,173.172,366.002,394,8760,0.354486,0,1,461257,460863,394
4020481,182.276,351.002,394,8760,0.316425,0,1,461503,461109,394
4023401,187.991,337.877,376,11680,0.280622,0,1,461731,461355,376
4026321,202.242,326.392,432,14600,0.256794,0,1,462033,461601,432
4029241,208.462,320.968,401,17520,0.238445,0,1,462285,461884,401
4032161,213.904,308.097,435,20440,0.234889,0,1,462537,462102,435
4035081,214.166,296.835,433,23360,0.231778,0,1,462753,462320,433
4038001,220.395,286.981,479,22859,0.236556,0,1,463017,462538,479
4040921,222.846,278.358,501,22299,0.255737,0,2,463257,462756,501
4043841,223.49,270.813,511,21872,0.282519,0,2,463485,462974,511
4046761,230.054,264.212,569,21552,0.313455,0,2,463761,463192,569
4049681,234.297,258.435,615,24366,0.348023,0,2,464025,463410,615
4052601,236.51,253.381,649,24366,0.38827,0,2,464277,463628,649
4055521,238.446,248.958,683,24366,0.445986,0,2,464529,463846,683
4058441,234.141,239.588,713,24366,0.511488,0,2,464733,464020,713
4061361,227.373,231.39,719,24366,0.571302,0,2,464913,464194,719
4075961,230.084,74.1729,2774,8760,0.923196,0,2,467925,465151,2774
4086181,293.938,477.479,766,5840,0.953729,0,2,469389,468623,766
4106621,236.879,216.054,2100,5840,0.995548,0,2,474045,471945,2100
4106621,229.173,165.416,2508,5840,0.987841,0,2,474453,471945,2508
4115381,349.026,529.489,618,21900,0.943111,0,2,475641,475023,618
4122681,314.398,476.928,581,23360,0.903972,0,2,475713,475132,581
4125601,287.098,430.937,568,24820,0.869726,0,2,475809,475241,568
4129981,269.211,390.695,603,26280,0.83976,0,2,475953,475350,603
4132901,262.56,355.483,710,27740,0.82854,0,2,476169,475459,710
4135821,256.74,338.298,708,28070,0.826222,0,2,476385,475677,708
4138741,256.147,323.26,742,24356,0.831695,0,2,476637,475895,742
4141661,255.629,310.103,776,24127,0.841483,0,2,476889,476113,776
4154801,231.43,111.087,2392,14600,0.965572,0,2,479721,477329,2392
4185461,183.703,350.668,1062,14600,0.996926,0,2,484161,483099,1062
4185461,190.74,306.834,1302,16060,0.98231,0,2,484401,483099,1302
4211741,153.62,318.715,1176,5840,0.990901,0,2,487293,486117,1176
4211741,171.918,278.875,1476,5840,0.969538,0,2,487593,486117,1476
4211741,172.928,244.016,1656,5840,0.947096,0,2,487773,486117,1656
4211741,170.812,213.514,1812,5840,0.917459,0,2,487929,486117,1812
4211741,155.46,186.825,1860,5840,0.884027,0,2,487977,486117,1860
4217581,302.528,505.347,457,29200,0.832273,0,2,489309,488852,457
4219041,278.212,451.178,493,30660,0.789489,0,2,489417,488924,493
4220501,249.435,403.781,469,32120,0.759553,0,2,489465,488996,469
4233641,224.256,362.308,445,33580,0.738359,0,2,489513,489068,445
4236561,217.224,326.02,541,35040,0.722314,0,2,489681,489140,541
4239481,215.571,303.267,601,37960,0.720775,0,2,489885,489284,601
4242401,212.625,283.359,649,40838,0.726928,0,2,490077,489428,649
4245321,204.047,265.939,649,39824,0.734812,0,2,490221,489572,649
4248241,199.541,250.697,673,38932,0.75421,0,2,490389,489716,673
4251161,200.098,237.36,733,38243,0.778684,0,2,490593,489860,733
4284741,193.825,121.186,2568,20440,0.98972,0,2,496497,493929,2568
4306641,199.273,330.597,1109,13140,0.993463,0,2,497937,496828,1109
4316861,161.527,312.714,1240,17520,0.978159,0,2,501009,499769,1240
4316861,174.336,273.625,1504,5840,0.948389,0,2,501273,499769,1504
4316861,178.044,239.422,1708,5840,0.926091,0,2,501477,499769,1708
4316861,172.289,209.494,1840,5840,0.891579,0,2,501609,499769,1840
4316861,164.253,183.307,1948,5840,0.856382,0,2,501717,499769,1948
4316861,154.221,160.394,2032,5840,0.818084,0,2,501801,499769,2032
4328541,298.443,481.845,608,24820,0.832074,0,2,503109,502501,608
4330001,276.138,434.114,628,20322,0.844314,0,2,503229,502601,628
4332921,256.621,392.35,648,20322,0.860025,0,2,503349,502701,648
4348981,238.043,355.806,656,20322,0.876272,0,2,503457,502801,656
4379641,213.517,73.7715,3114,7300,0.994525,0,2,510561,507447,3114
4379641,231.782,33.1083,4602,13140,0.988793,0,2,512049,507447,4602
4416141,220.397,511.443,1365,5840,0.971493,0,2,514809,513444,1365
4417601,247.847,535.637,1100,5840,0.926306,0,2,515249,514149,1100
4420521,239.866,501.683,1020,18546,0.884268,0,2,515433,514413,1020
4421981,242.383,475.972,984,21466,0.847484,0,2,515693,514709,984
4424901,247.085,483.976,724,22926,0.827799,0,2,515973,515249,724
4427821,244.7,452.979,716,25846,0.813074,0,2,516201,515485,716
4430741,244.112,425.857,720,26555,0.80769,0,2,516441,515721,720
4433661,249.598,402.124,772,26042,0.815479,0,2,516729,515957,772
4436581,252.898,381.359,812,25726,0.829794,0,2,517005,516193,812
4449721,235.216,54.7324,3964,11680,0.974614,0,2,521337,517373,3964
4449721,265.416,24.5636,5644,18980,0.982357,0,2,523017,517373,5644
4465781,243.621,336.663,2575,18980,0.995196,0,2,525861,523286,2575
4465781,243.168,294.58,2815,1460,0.992047,0,2,526101,523286,2815
4499361,209.371,331.974,1290,5840,0.991017,0,2,527613,526323,1290
4499361,216.55,254.168,1770,5840,0.985623,0,2,528093,526323,1770
4508121,379.981,549.022,681,20440,0.93867,0,2,529617,528936,681
4509581,352.358,499.519,687,21900,0.900086,0,2,529776,529089,687
4511041,324.814,456.204,666,23148,0.868825,0,2,529908,529242,666
4515421,297.712,418.304,621,24608,0.841472,0,2,530016,529395,621
4518341,294.998,385.141,744,26068,0.820038,0,2,530292,529548,744
4521261,298.623,375.248,762,25594,0.811283,0,2,530616,529854,762
4524181,294.295,362.842,750,25233,0.813623,0,2,530880,530130,750
4527101,293.508,348.237,792,24873,0.82317,0,2,531168,530376,792
4530021,292.82,335.457,834,24664,0.834024,0,2,531456,530622,834
4543161,305.599,291.883,1148,26787,0.913619,0,2,533000,531852,1148
4544621,245.794,106.331,2685,13140,0.967819,0,2,534660,531975,2685
4560681,255.613,365.671,1282,10220,0.990578,0,2,537840,536558,1282
4560681,246.917,164.111,2746,1460,0.990772,0,2,539304,536558,2746
4584041,205.828,139.748,2498,5840,0.983577,0,2,542040,539542,2498
4584041,213.1,122.279,2762,21900,0.96188,0,2,542304,539542,2762
4584041,213.462,106.994,2978,23360,0.930395,0,2,542520,539542,2978
4600101,248.279,430.12,778,24820,0.897845,0,2,543012,542234,778
4603021,230.744,393.355,750,26280,0.866865,0,2,543120,542370,750
4604481,206.401,357.811,677,27740,0.844757,0,2,543156,542479,677
4605941,194.101,326.709,676,28750,0.832912,0,2,543264,542588,676
4607401,178.839,299.496,639,25830,0.810048,0,2,543336,542697,639
4610321,168.484,275.684,626,25830,0.792542,0,2,543432,542806,626
4613241,175.923,254.848,745,25830,0.777224,0,2,543660,542915,745
4616161,182.433,250.242,755,25254,0.766321,0,2,543888,543133,755
4619081,191.129,246.212,789,26765,0.759281,0,2,544140,543351,789
4622001,197.238,249.435,757,26413,0.765621,0,2,544380,543623,757
4624921,208.583,252.256,773,26015,0.788668,0,2,544668,543895,773
4651201,205.374,43.3255,4200,14600,0.978672,0,2,552108,547908,4200
4686241,240.578,359.6,2295,5840,0.993732,0,2,555732,553437,2295
4686241,245.006,314.65,2571,24820,0.965765,0,2,556008,553437,2571
4690621,295.38,589.568,705,26280,0.908795,0,2,556656,555951,705
4693541,270.457,530.122,687,27740,0.856445,0,2,556752,556065,687
4697921,245.65,478.107,645,29200,0.81064,0,2,556824,556179,645
4703761,226.944,432.594,627,29404,0.76556,0,2,556920,556293,627
4706681,218.076,392.769,669,29404,0.731115,0,2,557076,556407,669
4709601,214.816,372.173,633,28558,0.703475,0,2,557268,556635,633
4712521,214.964,354.152,621,27713,0.686791,0,2,557484,556863,621
4715441,221.094,338.383,657,26945,0.687192,0,2,557748,557091,657
4718361,227.957,324.585,705,26381,0.712543,0,2,558024,557319,705
4732961,224.549,100.961,2535,11680,0.945589,0,2,561108,558573,2535
4768001,223.951,419.158,989,10220,0.996741,0,2,568284,567295,989
4768001,224.193,214.99,2112,5840,0.969579,0,2,569407,567295,2112
4785521,320.669,522.616,432,21571,0.882131,0,1,570403,569971,432
4788441,292.585,475.039,386,16921,0.798115,0,1,570499,570113,386
4800121,274.012,433.409,388,16921,0.727101,0,1,570643,570255,388
4803041,274.261,396.983,522,16921,0.674963,0,2,570919,570397,522
4804501,291.978,392.61,576,16298,0.654343,0,2,571335,570759,576
4805961,286.981,371.034,608,15846,0.6538,0,2,571587,570979,608
4807421,287.108,352.155,676,15501,0.670825,0,2,571875,571199,676
4808881,288.72,335.635,756,15315,0.708222,0,2,572175,571419,756
4826401,249.203,21.0601,5384,14600,0.992188,0,2,579355,573971,5384
4826401,248.052,18.4276,5624,14894,0.989414,0,2,579595,573971,5624
4826401,263.519,4.84785,8384,13140,0.994715,0,2,582355,573971,8384
4826401,263.256,3.24768,9164,5840,0.99021,0,2,583135,573971,9164
4881881,447.372,672.86,1112,20269,0.993674,0,2,590787,589675,1112
4883341,257.65,55.3898,5208,1460,0.98325,0,2,595075,589867,5208
4883341,250.944,48.4661,5412,5840,0.961593,0,2,595279,589867,5412
4883341,245.076,42.4078,5616,7300,0.945144,0,2,595483,589867,5616
4883341,236.941,37.1069,5796,8760,0.925751,0,2,595663,589867,5796
4912541,225.324,674.343,805,10220,0.901282,0,2,595807,595002,805
4912541,218.158,590.051,973,11680,0.884872,0,2,595975,595002,973
4912541,207.388,516.294,1105,11680,0.863013,0,2,596107,595002,1105
4912541,203.965,451.757,1285,11680,0.843886,0,2,596287,595002,1285
4915461,221.969,491.288,865,11680,0.804651,0,2,596635,595770,865
4918381,236.223,477.877,817,14600,0.755319,0,2,596971,596154,817
4921301,241.195,466.142,709,17520,0.719654,0,2,597247,596538,709
4924221,250.046,455.874,637,19861,0.685948,0,2,597559,596922,637
4925681,275.29,446.89,705,19222,0.651454,0,2,598011,597306,705
4927141,266.379,415.029,717,18797,0.626272,0,2,598215,597498,717
4930061,254.581,387.15,697,20257,0.611738,0,2,598387,597690,697
4932981,267.759,386.756,673,21017,0.611521,0,2,598747,598074,673
4935901,283.789,381.537,724,20667,0.631331,0,2,599143,598419,724
4937361,292.815,372.095,774,20454,0.668665,0,2,599499,598725,774
4938821,281.713,344.708,825,20813,0.701331,0,2,599703,598878,825
4950501,247.54,131.856,2380,8760,0.917499,0,2,602467,600087,2380
4950501,246.597,115.374,2620,8760,0.915312,0,2,602707,600087,2620
5032261,266.306,130.425,2736,1460,0.993725,0,2,619591,616855,2736
5032261,263.017,114.122,2976,5840,0.97701,0,2,619831,616855,2976
5055621,223.492,144.447,2133,7300,0.990948,0,2,622615,620482,2133
5055621,224.056,126.392,2361,7300,0.98333,0,2,622843,620482,2361
5067301,222.168,307.94,888,5840,0.973487,0,2,623275,622387,888
5067301,216.897,269.448,1068,5840,0.953051,0,2,623455,622387,1068
5067301,216.785,235.767,1284,5840,0.90267,0,2,623671,622387,1284
5067301,210.686,206.296,1452,5840,0.841086,0,2,623839,622387,1452
5067301,209.851,180.509,1656,5840,0.7722,0,1,624043,622387,1656
5067301,207.619,157.945,1848,21900,0.696925,0,1,624235,622387,1848
5076061,192.167,320.327,475,22607,0.623559,0,1,624319,623844,475
5078981,195.146,301.911,518,5840,0.551865,0,1,624535,624017,518
5081901,204.003,307.422,438,8760,0.484131,0,1,624801,624363,438
5084821,219.502,312.245,420,11680,0.432365,0,1,625129,624709,420
5087741,236.69,316.464,431,14600,0.389569,0,1,625486,625055,431
5090661,256.603,320.156,481,17520,0.367123,0,1,625882,625401,481
5093581,274.028,323.387,531,15426,0.357483,0,1,626278,625747,531
5096501,296.774,330.963,603,17959,0.351547,0,2,626734,626131,603
5097961,304.178,336.968,580,17751,0.358854,0,2,627090,626510,580
5099421,293.155,315.847,628,17530,0.380247,0,2,627306,626678,628
5102341,282.511,297.366,668,17420,0.402716,0,2,627514,626846,668
5103801,294.697,302.195,712,17392,0.436127,0,2,627894,627182,712
5106721,281.86,285.421,736,17392,0.467861,0,2,628086,627350,736
5109641,294.628,291.743,784,17392,0.520628,0,2,628470,627686,784
5121321,229.495,97.9476,2468,8760,0.908015,0,2,631490,629022,2468
5146141,215.937,104.72,2748,11680,0.990435,0,2,635714,632966,2748
5146141,204.5,41.1231,4128,8760,0.988744,0,2,637094,632966,4128
5162201,202.893,237.147,1941,5840,0.973698,0,2,638318,636377,1941
5175341,387.531,592.004,545,1460,0.920736,0,2,639998,639453,545
5176801,434.59,586.128,764,19427,0.889394,0,2,640762,639998,764
5178261,410.266,538.112,802,19007,0.87197,0,2,641002,640200,802
5179721,387.483,496.098,828,18718,0.854224,0,2,641230,640402,828
5181181,366.047,459.336,842,18502,0.846196,0,2,641446,640604,842
5182641,347.291,427.169,856,18343,0.846671,0,2,641662,640806,856
5184101,332.38,399.023,882,18227,0.849587,0,2,641890,641008,882
5185561,316.332,374.395,884,18169,0.857139,0,2,642094,641210,884
5187021,302.291,352.846,886,18126,0.866246,0,2,642298,641412,886
5188481,294.505,333.99,924,18097,0.879216,0,2,642538,641614,924
5219141,235.194,365.475,935,10220,0.99385,0,2,648026,647091,935
5219141,241.408,164.024,2411,17520,0.98724,0,2,649502,647091,2411
5219141,239.732,143.521,2639,1460,0.986335,0,2,649730,647091,2639
5241041,234.312,169.28,2148,8760,0.978498,0,2,652502,650354,2148
5241041,235.023,148.12,2388,5840,0.948685,0,2,652742,650354,2388
5241041,232.645,129.605,2604,5840,0.92385,0,2,652958,650354,2604
5241041,289.064,113.405,3288,1460,0.872119,0,2,653642,650354,3288
5249801,255.931,431.854,651,17520,0.826854,0,2,653666,653015,651
5252721,288.44,456.247,540,18980,0.794747,0,2,654182,653642,540
5257101,274.885,419.716,556,20440,0.774154,0,2,654362,653806,556
5260021,279.524,387.752,704,21900,0.768634,0,2,654674,653970,704
5261481,290.584,380.283,744,23359,0.783805,0,2,655042,654298,744
5264401,283.261,353.248,812,22754,0.799579,0,2,655274,654462,812
5284841,222.935,4.28273,8160,20440,0.985819,0,2,665846,657686,8160
5284841,223.568,3.74738,8388,21900,0.972592,0,2,666074,657686,8388
5284841,224.122,3.27896,8616,5840,0.947268,0,2,666302,657686,8616
5284841,214.107,2.86909,8760,5840,0.925109,0,2,666446,657686,8760
5284841,203.843,2.51045,8892,5840,0.888221,0,2,666578,657686,8892
5284841,193.363,2.19665,9012,5840,0.860943,0,2,666698,657686,9012
5284841,184.193,1.92207,9132,5840,0.834575,0,2,666818,657686,9132
5330101,528.669,1463.68,376,21900,0.784003,0,2,669758,669382,376
5340321,488.085,1300.72,420,23360,0.747253,0,2,669962,669542,420
5341781,474.574,1158.13,640,23615,0.725096,0,2,670342,669702,640
5343241,440.753,1033.36,684,22775,0.723209,0,2,670546,669862,684
5344701,411.158,924.194,728,24235,0.729058,0,2,670750,670022,728
5347621,381.264,828.67,740,24600,0.749176,0,2,670922,670182,740
5359301,262.733,214.56,2504,11680,0.93948,0,2,673934,671430,2504
5359301,258.391,187.74,2732,13140,0.938295,0,2,674162,671430,2732
5410401,222.359,404.189,979,10220,0.987767,0,2,680930,679951,979
5410401,224.564,353.666,1219,11680,0.968046,0,2,681170,679951,1219
5410401,226.494,309.457,1459,13140,0.93954,0,2,681410,679951,1459
5410401,225.182,270.775,1675,13140,0.898348,0,2,681626,679951,1675
5410401,206.034,236.928,1747,5840,0.859804,0,2,681698,679951,1747
5410401,204.28,207.312,1939,5840,0.816079,0,2,681890,679951,1939
5410401,193.745,181.398,2059,5840,0.770319,0,2,682010,679951,2059
5410401,184.527,158.724,2179,5840,0.732779,0,2,682130,679951,2179
5413321,269.461,455.383,511,23360,0.712432,0,2,682994,682483,511
5427921,261.278,421.96,527,19460,0.707128,0,2,683198,682671,527
5429381,282.119,392.715,767,19460,0.717487,0,2,683626,682859,767
5430841,272.354,367.126,783,20920,0.741551,0,2,683830,683047,783
5432301,269.81,344.735,847,21837,0.767607,0,2,684082,683235,847
5443981,229.036,126.373,2189,8760,0.945692,0,2,686738,684549,2189
5443981,228.907,110.577,2417,8760,0.931231,0,2,686966,684549,2417
5443981,230.293,96.7544,2657,10220,0.938577,0,2,687206,684549,2657
5458581,245.501,39.7013,5144,16060,0.995495,0,2,692726,687582,5144
5458581,243.617,17.8178,6596,8760,0.995478,0,2,694178,687582,6596
5473181,243.165,745.591,996,10220,0.982294,0,2,694418,693422,996
5473181,242.769,652.392,1236,5840,0.983257,0,2,694658,693422,1236
5473181,240.923,570.843,1464,5840,0.9666,0,2,694886,693422,1464
5473181,239.308,499.487,1692,5840,0.939525,0,2,695114,693422,1692
5495081,365.394,765.551,312,1460,0.830834,0,1,696362,696050,312
5496541,379.22,708.858,476,19957,0.74323,0,1,696838,696362,476
5498001,363.318,649.875,491,19183,0.669076,0,1,697090,696599,491
5499461,349.403,598.266,506,18519,0.619192,0,1,697342,696836,506
5500921,335.727,553.108,509,17966,0.583043,0,2,697582,697073,509
5502381,323.762,507.719,559,17385,0.578912,0,2,697822,697263,559
5503841,313.291,468.004,609,17045,0.580298,0,2,698062,697453,609
5505301,307.13,433.254,683,16826,0.594011,0,2,698326,697643,683
5506761,301.739,403.097,755,16740,0.62851,0,2,698590,697835,755
5518441,228.358,135.682,2079,7300,0.925779,0,2,701450,699371,2079
5518441,229.814,118.722,2319,7300,0.928806,0,2,701690,699371,2319
5528661,229.587,306.757,924,8760,0.932705,0,2,701918,700994,924
5528661,223.388,268.412,1104,8760,0.937367,0,2,702098,700994,1104
5528661,201.621,105.404,2388,16181,0.972904,0,2,703382,700994,2388
5541801,206.418,302.229,948,17402,0.973791,0,2,703622,702674,948
5575381,257.503,278.458,1143,5840,0.985035,0,2,709241,708098,1143
5576841,253.815,273.651,1131,5840,0.948156,0,2,709469,708338,1131
5578301,250.588,265.819,1148,11680,0.912136,0,2,709697,708549,1148
5579761,244.765,261.092,1124,13140,0.871869,0,2,709901,708777,1124
5582681,249.169,286.456,940,14600,0.816635,0,2,710181,709241,940
5585601,249.523,300.899,790,17520,0.763306,0,2,710433,709643,790
5588521,245.333,306.786,658,20440,0.714143,0,2,710649,709991,658
5591441,258.166,311.938,658,20674,0.676125,0,2,710997,710339,658
5592901,268.895,316.446,654,20272,0.650359,0,2,711341,710687,654
5595821,259.783,298.64,676,19751,0.630314,0,2,711537,710861,676
5598741,272.31,304.81,688,19349,0.627775,0,2,711897,711209,688
5600201,285.772,310.209,720,19013,0.635553,0,2,712277,711557,720
5603121,277.55,293.183,766,19696,0.644859,0,2,712497,711731,766
5606041,292.356,300.035,814,19609,0.685502,0,2,712893,712079,814
5616261,245.448,111.371,2452,8760,0.929155,0,2,715821,713369,2452
5616261,244.767,97.4495,2692,10220,0.93176,0,2,716061,713369,2692
5642541,280.03,327.618,1148,17352,0.972048,0,2,718973,717825,1148
5644001,275.026,310.666,1196,17352,0.973042,0,2,719213,718017,1196
5657141,238.417,212.922,2277,5840,0.995063,0,2,723177,720900,2277
5657141,238.615,186.307,2517,5840,0.97193,0,2,723417,720900,2517
5657141,238.788,163.019,2757,5840,0.934189,0,2,723657,720900,2757
5657141,295.939,142.641,3453,1460,0.866165,0,2,724353,720900,3453
5674661,260.447,470.311,701,18812,0.809145,0,2,724365,723664,701
5677581,308.891,497.647,660,20272,0.761752,0,2,725013,724353,660
5680501,303.28,473.691,618,23085,0.727783,0,2,725277,724659,618
5683421,308.87,452.73,660,22370,0.71306,0,2,725625,724965,660
5686341,313.761,434.389,702,21823,0.715177,0,2,725973,725271,702
5689261,318.041,418.34,744,21428,0.73953,0,2,726321,725577,744
5711161,245.386,213.464,1640,11680,0.973955,0,2,730737,729097,1640
5731601,274.518,278.322,1180,14600,0.990255,0,2,733781,732601,1180
5733061,214.1,91.0674,2620,10220,0.99582,0,2,735393,732773,2620
5733061,211.482,40.8706,3868,8760,0.994374,0,2,736641,732773,3868
5749121,215.047,418.012,1050,10220,0.991327,0,2,736881,735831,1050
5749121,238.895,320.04,1674,5840,0.96711,0,2,737505,735831,1674
5749121,237.533,280.035,1902,5840,0.909971,0,2,737733,735831,1902
5759341,356.842,602.531,234,19742,0.799975,0,1,738925,738691,234
5762261,356.737,548.714,418,21202,0.713728,0,1,739281,738863,418
5765181,357.895,523.125,440,21712,0.633262,0,1,739647,739207,440
5766641,359.158,500.735,464,20574,0.575354,0,1,740015,739551,464
5768101,339.763,459.643,496,19641,0.529685,0,1,740219,739723,496
5769561,322.793,423.687,528,18877,0.509724,0,2,740423,739895,528
5772481,306.944,392.226,552,18282,0.497259,0,2,740619,740067,552
5773941,320.576,386.198,624,15851,0.496351,0,2,741035,740411,624
5775401,306.004,359.423,656,17311,0.508058,0,2,741239,740583,656
5776861,296.253,335.995,712,18771,0.5258,0,2,741467,740755,712
5778321,290.722,319.121,763,19191,0.561325,0,2,741719,740956,763
5781241,280.381,304.356,770,19191,0.60241,0,2,741927,741157,770
5782701,288.334,304.061,812,19191,0.648358,0,2,742271,741459,812
5794381,246.112,122.574,2320,13140,0.909055,0,2,744987,742667,2320
5794381,245.348,107.252,2560,14600,0.914173,0,2,745227,742667,2560
5810441,220.802,163.424,2143,19191,0.981124,0,2,748107,745964,2143
5810441,264.83,22.0514,5839,5840,0.993703,0,2,751803,745964,5839
5810441,260.226,19.295,6067,5840,0.94699,0,2,752031,745964,6067
5810441,257.698,16.8831,6307,5840,0.891116,0,2,752271,745964,6307
5825041,298.986,807.273,555,19191,0.820977,0,2,752859,752304,555
5827961,276.613,726.364,515,20651,0.759605,0,2,752979,752464,515
5842561,257.036,655.568,475,21406,0.710904,0,2,753099,752624,475
5851321,244.407,593.622,471,21406,0.668291,0,2,753255,752784,471
5854241,251.356,539.419,611,21406,0.643505,0,2,753555,752944,611
5857161,261.936,511.992,627,20786,0.636817,0,2,753891,753264,627
5860081,278.694,487.993,703,20275,0.640965,0,2,754287,753584,703
5863001,291.857,466.994,767,20001,0.667094,0,2,754671,753904,767
5865921,301.875,448.62,819,19910,0.707457,0,2,755043,754224,819
5876141,252.251,158.233,2323,8760,0.926409,0,2,757827,755504,2323
5876141,250.72,138.453,2563,8760,0.934358,0,2,758067,755504,2563
5898041,232.219,209.694,2004,8760,0.978431,0,2,761019,759015,2004
5914101,230.502,304.914,963,11680,0.98153,0,2,762615,761652,963
5921401,252.88,268.466,1187,16804,0.988027,0,2,764039,762852,1187
5922861,222.914,116.645,2359,5840,0.971548,0,2,765411,763052,2359
5922861,225.05,102.065,2599,5840,0.950105,0,2,765651,763052,2599
5933081,225.419,297.182,1164,5840,0.936341,0,2,765879,764715,1164
5933081,242.241,260.034,1524,5840,0.908049,0,2,766239,764715,1524
5933081,234.461,227.53,1704,20381,0.880793,0,2,766419,764715,1704
5933081,230.654,199.088,1908,20381,0.861944,0,2,766623,764715,1908
5933081,237.822,174.202,2196,20381,0.852951,0,2,766911,764715,2196
5941841,229.094,367.927,640,20381,0.850082,0,2,767079,766439,640
5943301,253.957,346.936,868,5840,0.855072,0,2,767507,766639,868
5944761,250.713,328.569,896,7300,0.871938,0,2,767735,766839,896
5965201,233.925,133.27,2872,5840,0.993522,0,2,773694,770822,2872
5987101,264.043,351.572,1145,11680,0.994178,0,2,775106,773961,1145
5988561,261.038,335.126,1165,13140,0.993655,0,2,775346,774181,1165
6004621,222.994,226.664,1408,11680,0.990132,0,2,778230,776822,1408
6006081,247.232,296.347,1112,5840,0.980889,0,2,779090,777978,1112
6007541,243.328,286.804,1108,18980,0.950778,0,2,779306,778198,1108
6009001,242.912,278.453,1128,19058,0.925681,0,2,779546,778418,1128
6010461,238.048,271.147,1112,19058,0.896221,0,2,779750,778638,1112
6013381,241.792,293.753,928,19058,0.855443,0,2,780018,779090,928
6016301,259.568,312.034,872,19058,0.802263,0,2,780402,779530,872
6019221,267.622,328.03,756,18793,0.76073,0,2,780726,779970,756
6020681,280.169,342.026,684,18328,0.729389,0,2,781094,780410,684
6022141,273.648,326.773,692,17797,0.709465,0,2,781322,780630,692
6023601,270.942,313.426,724,17346,0.699532,0,2,781574,780850,724
6025061,265.574,301.748,732,17001,0.69084,0,2,781802,781070,732
6026521,262.378,291.529,752,16709,0.683235,0,2,782042,781290,752
6027981,261.08,282.588,784,16497,0.679081,0,2,782294,781510,784
6029441,259.945,274.765,816,16364,0.685446,0,2,782546,781730,816
6030901,255.952,267.919,824,17824,0.698515,0,2,782774,781950,824
6032361,255.458,261.929,856,19178,0.717451,0,2,783026,782170,856
6033821,253.526,256.688,876,19178,0.741519,0,2,783266,782390,876
6046961,229.211,104.404,2408,8760,0.939445,0,2,786426,784018,2408
6058641,230.56,297.854,996,8760,0.930765,0,2,786666,785670,996
6080541,251.394,270.365,1118,16060,0.980347,0,2,790994,789876,1118
6082001,249.97,262.32,1152,17025,0.970304,0,2,791234,790082,1152
6082001,223.724,229.53,1192,17025,0.972766,0,2,791274,790082,1192
6082001,229.447,103.012,2596,10220,0.982777,0,2,792678,790082,2596
6100981,210.115,364.122,931,11680,0.978521,0,2,793890,792959,931
6100981,213.851,318.607,1171,13140,0.946205,0,2,794130,792959,1171
6100981,215.62,278.781,1399,13140,0.91918,0,2,794358,792959,1399
6103901,223.167,329.808,988,13140,0.898032,0,2,794634,793646,988
6106821,228.271,342.332,822,16060,0.874528,0,2,794898,794076,822
6109741,235.737,338.541,798,18980,0.843962,0,2,795186,794388,798
6112661,246.77,335.223,810,21900,0.824717,0,2,795510,794700,810
6115581,250.424,332.32,774,23115,0.807877,0,2,795786,795012,774
6118501,255.121,329.78,750,22685,0.798143,0,2,796074,795324,750
6121421,269.731,327.558,810,22254,0.809625,0,2,796446,795636,810
6124341,282.514,325.613,870,22029,0.829672,0,2,796818,795948,870
6136021,228.803,121.227,2226,10220,0.964443,0,2,799578,797352,2226
6168141,210.482,165.844,2269,17721,0.994034,0,2,805507,803238,2269
6168141,221.486,74.4299,3661,10220,0.994822,0,2,806899,803238,3661
6194421,421.3,750.301,664,1460,0.966094,0,2,809599,808935,664
6210481,321.001,378.042,1070,19082,0.979695,0,2,813159,812089,1070
6211941,309.376,355.662,1099,19082,0.979733,0,2,813387,812288,1099
6211941,259.271,159.619,2351,10220,0.988404,0,2,814639,812288,2351
6242601,254.076,270.357,1125,16643,0.995052,0,2,818943,817818,1125
6251361,244.8,253.624,1101,16643,0.987779,0,2,820359,819258,1101
6258661,238.524,246.988,1065,5840,0.991232,0,2,821523,820458,1065
6260121,243.209,246.114,1101,5840,0.953578,0,2,821799,820698,1101
6261581,242.808,245.35,1101,5840,0.910631,0,2,822039,820938,1101
6263041,239.457,257.806,972,5840,0.865552,0,2,822255,821283,972
6265961,240.025,255.581,976,18018,0.831108,0,2,822499,821523,976
6267421,257.522,288.133,840,17872,0.808469,0,2,822879,822039,840
6268881,252.331,282.116,816,17531,0.793661,0,2,823095,822279,816
6270341,250.79,276.852,816,17203,0.783203,0,2,823335,822519,816
6271801,252.441,272.245,840,16911,0.779053,0,2,823599,822759,840
6273261,250.886,268.215,840,16692,0.777921,0,2,823839,822999,840
6274721,254.025,264.688,876,16497,0.784431,0,2,824115,823239,876
6276181,255.272,261.602,900,16388,0.795127,0,2,824379,823479,900
6277641,254.863,258.902,912,16327,0.806986,0,2,824631,823719,912
6279101,257.505,256.539,948,16290,0.827363,0,2,824907,823959,948
6295161,251.674,243.807,1056,17750,0.95901,0,2,827655,826599,1056
6305381,241.802,225.651,1164,18227,0.980154,0,2,829299,828135,1164
6319981,250.577,335.868,1349,10220,0.994002,0,2,832339,830990,1349
6319981,241.389,150.736,2753,1460,0.986058,0,2,833743,830990,2753
6337501,237.834,300.878,1388,5840,0.989993,0,2,835135,833747,1388
6337501,238.105,263.268,1628,5840,0.966244,0,2,835375,833747,1628
6337501,238.342,230.36,1868,5840,0.942963,0,2,835615,833747,1868
6337501,280.549,201.565,2444,1460,0.916343,0,2,836191,833747,2444
6337501,264.98,176.369,2600,5840,0.90055,0,2,836347,833747,2600
6337501,251.358,154.323,2756,7300,0.879231,0,2,836503,833747,2756
6337501,236.438,135.033,2888,8760,0.853077,0,2,836635,833747,2888
6340421,223.383,407.029,709,10220,0.840193,0,2,836767,836058,709
6349181,211.96,376.15,681,11680,0.831419,0,2,836899,836218,681
6349181,207.965,329.131,861,13140,0.826241,0,2,837079,836218,861
6349181,198.47,287.99,993,13140,0.829211,0,2,837211,836218,993
6363781,197.34,71.3531,2808,17520,0.974455,0,2,840343,837535,2808
6363781,202.672,62.434,3048,1460,0.976398,0,2,840583,837535,3048
6372541,187.802,278.248,1368,14600,0.98189,0,2,841951,840583,1368
6392981,222.089,265.517,1416,14600,0.986352,0,2,844807,843391,1416
6392981,224.328,232.328,1656,16060,0.985558,0,2,845047,843391,1656
6392981,216.728,91.2341,3132,7300,0.991829,0,2,846523,843391,3132
6442621,305.918,401.77,1108,21789,0.994354,0,2,852567,851459,1108
6464521,236.692,162.002,2029,7300,0.998408,0,2,857011,854982,2029
6464521,237.105,141.752,2269,7300,0.996107,0,2,857251,854982,2269
6480581,234.648,308.207,947,11680,0.990753,0,2,858631,857684,947
6489341,241.494,135.957,2251,4380,0.988137,0,2,861631,859380,2251
6498101,238.307,334.338,744,19963,0.98337,0,2,861847,861103,744
6499561,266.519,324.045,956,5840,0.981699,0,2,862311,861355,956
6501021,278.204,318.04,1040,7300,0.977737,0,2,862671,861631,1040
6503941,267.928,304.785,1024,8760,0.97427,0,2,862867,861843,1024
6505401,292.437,325.187,1020,11680,0.976236,0,2,863331,862311,1020
6518541,210.352,23.1827,4850,14600,0.991656,0,2,868831,863981,4850
6562341,251.394,352.85,1196,13140,0.99309,0,2,873555,872359,1196
6563801,205.817,149.783,2200,5840,0.993537,0,2,874759,872559,2200
6575481,244.326,165.248,2436,21705,0.996212,0,2,876655,874219,2436
6590081,229.516,189.655,1845,7300,0.990378,0,2,879175,877330,1845
6590081,224.826,165.948,2037,7300,0.985331,0,2,879367,877330,2037
6590081,217.723,145.204,2205,8760,0.980914,0,2,879535,877330,2205
6636801,198.008,300.51,1188,14600,0.998073,0,2,885067,883879,1188
6651401,209.058,113.645,2373,10220,0.994848,0,2,889231,886858,2373
6651401,212.926,99.4398,2613,10220,0.982992,0,2,889471,886858,2613
6673301,217.76,140.512,2256,5840,0.974877,0,2,892555,890299,2256
6673301,219.04,122.948,2484,5840,0.964267,0,2,892783,890299,2484
6674761,215.66,307.079,1080,1460,0.959984,0,2,892975,891895,1080
6698121,216.977,106.605,2332,1460,0.994025,0,2,896395,894063,2332
6709801,219.855,282.779,1056,5840,0.988522,0,2,896635,895579,1056
6718561,211.123,112.541,2252,8760,0.996727,0,2,899431,897179,2252
6718561,218.028,44.1944,3800,11680,0.987465,0,2,900979,897179,3800
6718561,221.119,17.3549,5396,20440,0.993827,0,2,902575,897179,5396
6757981,169.865,193.514,2348,5840,0.994271,0,2,905287,902939,2348
6757981,178.632,169.324,2588,18980,0.958737,0,2,905527,902939,2588
6768201,184.803,381.659,948,20440,0.942645,0,2,905755,904807,948
6768201,209.702,333.952,1332,21900,0.941065,0,2,906139,904807,1332
6771121,189.49,374.333,723,21900,0.944681,0,2,906187,905464,723
6772581,173.303,335.041,723,23360,0.945346,0,2,906247,905524,723
6774041,163.64,300.661,759,24820,0.940928,0,2,906343,905584,759
6775501,149.185,270.578,747,26280,0.942062,0,2,906391,905644,747
6776961,133.537,244.256,711,27740,0.940554,0,2,906415,905704,711
6779881,125.845,221.224,723,29200,0.936735,0,2,906487,905764,723
6782801,131.114,201.071,831,30660,0.933393,0,2,906655,905824,831
6785721,132.725,190.937,855,33580,0.935469,0,2,906799,905944,855
6788641,131.134,182.07,855,36500,0.934785,0,2,906919,906064,855
6791561,128.243,174.311,843,39420,0.934187,0,2,907027,906184,843
6794481,131.712,167.522,879,42340,0.933664,0,2,907183,906304,879
6797401,124.248,161.582,831,45260,0.933206,0,2,907255,906424,831
6822221,225.933,4.70353,5607,7300,0.993037,0,2,913111,907504,5607
6825141,227.692,595.991,1112,8760,0.992657,0,2,913351,912239,1112
6883541,186.59,353.208,1121,14600,0.987759,0,2,916159,915038,1121
6905441,152.966,249.721,1044,5840,0.987782,0,2,918967,917923,1044
6906901,177.345,301.006,732,5840,0.973059,0,2,919315,918583,732
6911281,179.177,273.88,840,20440,0.965177,0,2,919507,918667,840
6914201,192.78,247.52,1065,21900,0.95328,0,2,919795,918730,1065
6917121,212.182,289.705,828,24820,0.95287,0,2,920143,919315,828
6920041,202.16,269.242,834,27740,0.955011,0,2,920275,919441,834
6922961,190.39,251.337,816,30660,0.959385,0,2,920383,919567,816
6928801,179.33,221.961,852,36500,0.965154,0,2,920671,919819,852
6965301,192.216,40.7489,3348,11680,0.994833,0,2,927643,924295,3348
6993041,197.659,220.654,2544,5840,0.997091,0,2,931879,929335,2544
7029541,272.343,395.58,1109,23502,0.993295,0,2,933483,932374,1109
7031001,265.3,364.757,1176,23502,0.987883,0,2,933699,932523,1176
7047061,199.366,415.829,949,11680,0.992319,0,2,936583,935634,949
7047061,224.275,49.0957,4477,11680,0.995343,0,2,940111,935634,4477
7096701,300.859,550.758,1242,5840,0.996872,0,2,944583,943341,1242
7105461,231.819,177.409,2268,16060,0.98937,0,2,947371,945103,2268
7121521,220.709,319.836,1224,13140,0.988326,0,2,948919,947695,1224
7160941,612.958,1361.21,702,20440,0.998587,0,2,959251,958549,702
7178461,313.821,312.496,2691,7300,0.990965,0,2,962227,959536,2691
7195981,246.887,385.038,1378,11680,0.991452,0,2,963655,962277,1378
7223721,244.016,511.996,1166,11680,0.995947,0,2,969651,968485,1166
7225181,243.514,474.246,1196,13140,0.990203,0,2,969891,968695,1196
7225181,218.075,414.966,1236,14600,0.988928,0,2,969931,968695,1236
7254381,252.728,275.64,1126,18407,0.986499,0,2,974535,973409,1126
7289421,228.226,255.137,1199,11680,0.988202,0,2,980107,978908,1199
7301101,220.084,109.278,2339,10220,0.994431,0,2,983347,981008,2339
7311321,219.574,300.993,912,1460,0.987627,0,2,983563,982651,912
7328841,204.796,114.816,2065,10220,0.997894,0,2,987583,985518,2065
7328841,206.196,100.464,2281,10220,0.993157,0,2,987799,985518,2281
7328841,202.922,87.9059,2461,11680,0.991512,0,2,987979,985518,2461
7356581,232.028,135.987,2402,5840,0.986623,0,2,992035,989633,2402
7366801,233.025,329.239,960,1460,0.974545,0,2,992275,991315,960
7388701,255.003,371.885,904,10220,0.996449,0,2,996679,995775,904
7388701,253.128,325.4,1144,11680,0.993143,0,2,996919,995775,1144
7398921,232.004,129.853,2358,7300,0.997369,0,2,999799,997441,2358
7414981,224.232,303.584,906,10220,0.988819,0,2,1001119,1000213,906
7414981,224.703,265.636,1134,11680,0.988967,0,2,1001347,1000213,1134
7429581,249.467,260.109,1082,17733,0.99621,0,2,1004235,1003153,1082
7438341,248.002,251.781,1088,17722,0.988299,0,2,1005711,1004623,1088
7457321,260.396,247.526,1184,23049,0.996393,0,2,1008747,1007563,1184
7479221,201.959,228.755,1206,14600,0.998377,0,2,1011943,1010737,1206
7487981,248.005,266.782,1126,21900,0.997799,0,2,1013187,1012061,1126
7489441,214.959,97.9519,2514,11680,0.977994,0,2,1014703,1012189,2514
7489441,216.589,85.7079,2742,1460,0.979494,0,2,1014931,1012189,2742
7512801,176.347,309.856,937,16060,0.991335,0,2,1016311,1015374,937
7515721,206.05,173.061,1853,17520,0.988611,0,2,1017739,1015886,1853
7552221,175.176,79.6939,2616,1460,0.996111,0,2,1023739,1021123,2616
7603321,152.239,244.612,1020,17520,0.993629,0,2,1028047,1027027,1020
7631061,181.217,79.6458,2652,5840,0.997302,0,2,1032703,1030051,2652
7658801,183.38,213.251,1254,18980,0.997939,0,2,1034347,1033093,1254
7658801,196.757,83.7428,2682,5840,0.995441,0,2,1035775,1033093,2682
7679241,187.657,250.338,1132,16060,0.99696,0,2,1037059,1035927,1132
7679241,192.7,219.046,1360,16060,0.98984,0,2,1037287,1035927,1360
7702601,226.308,258.13,1208,16060,0.984879,0,2,1040367,1039159,1208
7702601,201.52,225.863,1236,17520,0.973019,0,2,1040395,1039159,1236
7702601,193.718,77.6087,2736,1460,0.989479,0,2,1041895,1039159,2736
7724501,200.751,104.085,2852,5840,0.99233,0,2,1044835,1041983,2852
7742021,255.163,312.801,1184,13140,0.992316,0,2,1046343,1045159,1184
7742021,228.268,273.701,1224,14600,0.989527,0,2,1046383,1045159,1224
7763921,207.181,162.464,2013,5840,0.998025,0,2,1050595,1048582,2013
7763921,208.283,142.156,2229,5840,0.997022,0,2,1050811,1048582,2229
7820861,194.367,139.771,2350,16060,0.996242,0,2,1060999,1058649,2350
7835461,211.457,252.59,1206,10220,0.984774,0,2,1062559,1061353,1206
7836921,250.574,309.849,1716,14600,0.991933,0,2,1065775,1064059,1716
7836921,208.717,54.6078,4308,16060,0.996078,0,2,1068367,1064059,4308
7836921,209.627,47.7818,4524,17520,0.991569,0,2,1068583,1064059,4524
7836921,235.475,24.5077,5856,1460,0.991925,0,2,1069915,1064059,5856
7895321,208.457,160.365,3031,5840,0.99177,0,2,1073198,1070167,3031
7912841,247.242,370.12,1161,13140,0.992029,0,2,1074598,1073437,1161
7914301,202.629,135.914,2379,10220,0.988511,0,2,1075994,1073615,2379
7914301,204.301,118.925,2595,11680,0.977447,0,2,1076210,1073615,2595
7939121,217.64,106.195,2924,1460,0.992189,0,2,1080230,1077306,2924
7939121,215.935,92.9202,3128,5840,0.991916,0,2,1080434,1077306,3128
7959561,203.798,131.791,2405,10220,0.997659,0,2,1083302,1080897,2405
7971241,209.01,138.876,2328,5840,0.996581,0,2,1084778,1082450,2328
7982921,305.364,391.13,1110,20440,0.996459,0,2,1086262,1085152,1110
7984381,295.694,362.739,1174,21900,0.989402,0,2,1086490,1085316,1174
7985841,288.732,337.896,1250,23360,0.989477,0,2,1086730,1085480,1250
7985841,225.134,116.104,2694,1460,0.992634,0,2,1088174,1085480,2694
8004821,221.142,305.641,1225,13140,0.989607,0,2,1089710,1088485,1225
8006281,202.809,129.172,2317,10220,0.991429,0,2,1091294,1088977,2317
8035481,231.632,265.849,1298,21900,0.997239,0,2,1094234,1092936,1298
8102641,153.537,89.5034,2472,5840,0.991249,0,2,1104398,1101926,2472
8102641,164.344,78.3155,2712,20440,0.972343,0,2,1104638,1101926,2712
8102641,173.801,68.5261,2952,21900,0.97455,0,2,1104878,1101926,2952
8136221,161.172,42.8625,2895,29200,0.989489,0,2,1108118,1105223,2895
8140601,131.985,268.914,1416,26280,0.983759,0,2,1109762,1108346,1416
8190241,184.232,262.689,1008,17520,0.994332,0,2,1112834,1111826,1008
8190241,186.434,90.2624,2496,29200,0.994303,0,2,1114322,1111826,2496
8190241,188.495,31.015,4008,14600,0.993042,0,2,1115834,1111826,4008
8209221,361.975,634.616,933,27649,0.986359,0,2,1119206,1118273,933
8209221,343.728,555.289,1149,24729,0.980564,0,2,1119422,1118273,1149
8209221,327.762,485.878,1365,24729,0.979244,0,2,1119638,1118273,1365
8209221,298.792,425.143,1461,24729,0.975588,0,2,1119734,1118273,1461
8209221,230.807,146.083,2925,5840,0.990362,0,2,1121198,1118273,2925
8260321,210.143,6.28711,7061,7300,0.997431,0,2,1128782,1121721,7061
8260321,197.113,2.82163,8189,14600,0.996347,0,2,1129910,1121721,8189
8260321,202.474,2.46892,8429,16060,0.983054,0,2,1130150,1121721,8429
8260321,234.695,1.26633,9785,23360,0.986308,0,2,1131506,1121721,9785
8260321,235.358,1.10804,10025,24820,0.97552,0,2,1131746,1121721,10025
8260321,181.638,0.380733,11249,5840,0.984088,0,2,1132970,1121721,11249
8260321,182.933,0.333141,11441,5840,0.976077,0,2,1133162,1121721,11441
8336241,278.758,520.694,2225,32484,0.993932,0,2,1137686,1135461,2225
8336241,273.913,455.607,2465,32484,0.98844,0,2,1137926,1135461,2465
8336241,221.498,31.532,6749,7300,0.97795,0,2,1142210,1135461,6749
8336241,215.282,4.86255,9557,23360,0.9791,0,2,1145018,1135461,9557
8336241,218.371,4.25473,9797,24820,0.959212,0,2,1145258,1135461,9797
8336241,219.575,3.72289,10025,26280,0.949311,0,2,1145486,1135461,10025
8336241,208.628,3.25753,10157,27740,0.951897,0,2,1145618,1135461,10157
8336241,190.05,2.85034,10217,29200,0.95416,0,2,1145678,1135461,10217
8336241,179.793,2.49405,10325,30660,0.95114,0,2,1145786,1135461,10325
8336241,161.819,2.18229,10361,32120,0.953497,0,2,1145822,1135461,10361
8336241,152.092,1.9095,10445,33580,0.95306,0,2,1145906,1135461,10445
8336241,149.58,1.67082,10577,34763,0.955178,0,2,1146038,1135461,10577
8336241,140.022,1.27922,10793,34763,0.959433,0,2,1146254,1135461,10793
8336241,145.02,1.11932,10973,34763,0.963254,0,2,1146434,1135461,10973
8336241,143.392,0.979402,11105,34763,0.959097,0,2,1146566,1135461,11105
8336241,146.468,0.856977,11273,34763,0.95046,0,2,1146734,1135461,11273
8336241,149.16,0.749854,11441,34763,0.940402,0,2,1146902,1135461,11441
8336241,148.515,0.656123,11585,34763,0.936602,0,2,1147046,1135461,11585
8336241,149.45,0.574107,11741,34763,0.928277,0,2,1147202,1135461,11741
8336241,145.769,0.502344,11861,34763,0.925992,0,2,1147322,1135461,11861
8336241,142.548,0.439551,11981,34763,0.926493,0,2,1147442,1135461,11981
8336241,141.229,0.384607,12113,34763,0.926932,0,2,1147574,1135461,12113
8336241,223.846,0.0178321,16277,21900,0.994112,0,2,1151738,1135461,16277
8336241,225.865,0.0156031,16517,23360,0.983598,0,2,1151978,1135461,16517
8468101,1283.44,2789.03,916,7300,0.979974,0,2,1165130,1164214,916
8478321,380.549,763.91,1139,11680,0.988162,0,2,1168110,1166971,1139
8478321,318.673,342.839,2735,18813,0.993437,0,2,1169706,1166971,2735
8568841,214.893,138.174,2696,1460,0.998746,0,2,1182822,1180126,2696
8586361,251.435,336.785,1284,24820,0.998187,0,2,1184438,1183154,1284
8586361,212.634,115.722,2728,11680,0.994377,0,2,1185882,1183154,2728
8606801,205.378,289.907,1344,13140,0.996818,0,2,1187454,1186110,1344
8606801,205.037,113.845,2772,5840,0.99375,0,2,1188882,1186110,2772
8643301,211.993,284.561,1064,11680,0.995817,0,2,1193262,1192198,1064
8643301,220.848,127.709,2456,5840,0.996873,0,2,1194654,1192198,2456
8643301,223.242,111.746,2696,1460,0.983514,0,2,1194894,1192198,2696
8644761,225.337,353.778,888,5840,0.984325,0,2,1195134,1194246,888
8675421,177.029,355.443,1005,16060,0.994051,0,2,1199219,1198214,1005
8726521,212.196,286.182,1293,35040,0.984987,0,2,1207859,1206566,1293
8726521,217.172,250.41,1545,36500,0.985614,0,2,1208111,1206566,1545
8726521,188.861,75.2876,3050,7300,0.990675,0,2,1209616,1206566,3050
8726521,254.685,25.8695,5318,18980,0.995546,0,2,1211884,1206566,5318
8726521,262.478,19.8063,5899,5840,0.98159,0,2,1212465,1206566,5899
8726521,234.32,3.05434,9019,24820,0.995911,0,2,1215585,1206566,9019
8726521,230.087,2.04617,9684,28379,0.996011,0,2,1216250,1206566,9684
8726521,225.326,1.7904,9876,29839,0.995259,0,2,1216442,1206566,9876
8809741,256.147,499.303,2652,1460,0.99826,0,2,1220767,1218115,2652
8845861,443.378,520.914,1696,11680,0.998645,0,2,1236760,1235064,1696
8866301,305.433,195.678,2810,1460,0.99859,0,2,1241205,1238395,2810
8879441,283.939,393.281,1276,10220,0.997923,0,2,1242218,1240942,1276
8885281,265.346,297.954,1691,23993,0.998272,0,2,1245110,1243419,1691
8926161,302.493,513.173,1097,14600,0.996158,0,2,1251435,1250338,1097
8939301,323.831,379.478,1167,17955,0.991345,0,2,1254403,1253236,1167
8940761,319.352,372.293,1133,17955,0.988677,0,2,1254691,1253558,1133
8956821,266.706,283.036,1045,18133,0.994893,0,2,1257471,1256426,1045
8977261,239.075,116.662,2405,8760,0.994538,0,2,1261971,1259566,2405
9000621,269.418,289.252,1155,17520,0.9914,0,2,1265051,1263896,1155
9022521,256.682,285.385,1100,20019,0.989112,0,2,1269203,1268103,1100
9023981,263.597,298.712,1020,20006,0.979223,0,2,1269515,1268495,1020
9042961,293.183,296.686,1072,19168,0.984534,0,2,1272435,1271363,1072
9044421,285.036,286.601,1084,19168,0.971467,0,2,1272663,1271579,1084
9045881,277.906,277.776,1096,19168,0.966284,0,2,1272891,1271795,1096
9067781,207.579,153.409,1836,11680,0.988917,0,2,1277179,1275343,1836
9070701,211.631,259.483,1074,13140,0.977802,0,2,1277419,1276345,1074
9101361,237.196,273.089,1186,21900,0.988464,0,2,1281687,1280501,1186
9117421,267.692,300.652,1064,10220,0.989844,0,2,1284471,1283407,1064
9118881,264.23,291.07,1080,11680,0.982364,0,2,1284711,1283631,1080
9174361,250.715,398.877,1058,8760,0.996176,0,2,1294843,1293785,1058
9194801,211.016,294.243,1346,5840,0.985576,0,2,1297471,1296125,1346
9197721,214.639,336.588,953,5840,0.961129,0,2,1297711,1296758,953
9197721,217.809,294.515,1193,5840,0.943488,0,2,1297951,1296758,1193
9197721,219.083,257.7,1421,17520,0.934302,0,2,1298179,1296758,1421
9197721,230.698,225.488,1733,18980,0.918764,0,2,1298491,1296758,1733
9197721,230.361,197.302,1961,7300,0.902669,0,2,1298719,1296758,1961
9197721,225.565,172.639,2153,8760,0.881085,0,2,1298911,1296758,2153
9197721,206.37,151.059,2225,10220,0.864699,0,2,1298983,1296758,2225
9197721,201.574,132.177,2393,1460,0.852862,0,2,1299151,1296758,2393
9209401,183.877,332.28,720,5840,0.845004,0,2,1299211,1298491,720
9212321,205.892,319.245,852,7300,0.850629,0,2,1299571,1298719,852
9212321,192.156,279.339,948,10220,0.85555,0,2,1299667,1298719,948
9212321,190.636,244.422,1128,10220,0.864856,0,2,1299847,1298719,1128
9212321,192.307,213.869,1332,10220,0.875499,0,2,1300051,1298719,1332
9240061,226.127,65.6769,3712,11680,0.992014,0,2,1307299,1303587,3712
9240061,247.129,15.1182,6640,13140,0.996912,0,2,1310227,1303587,6640
9240061,276.633,7.75428,8140,5840,0.979666,0,2,1311727,1303587,8140
9240061,270.554,6.78499,8368,5840,0.947208,0,2,1311955,1303587,8368
9256121,593.735,1333.56,603,17520,0.932557,0,2,1314811,1314208,603
9260501,533.018,1178.12,621,18980,0.929737,0,2,1314919,1314298,621
9264881,476.891,1042.1,615,20440,0.93227,0,2,1315003,1314388,615
9301381,245.895,188.591,2553,11680,0.985805,0,2,1317751,1315198,2553
9301381,245.158,165.017,2793,11680,0.97758,0,2,1317991,1315198,2793
9337881,191.862,39.3004,4053,14600,0.99611,0,2,1325299,1321246,4053
9337881,197.879,34.3878,4293,16060,0.994096,0,2,1325539,1321246,4293
9337881,203.144,30.0893,4533,17520,0.992334,0,2,1325779,1321246,4533
9337881,177.46,20.1575,4894,5840,0.971114,0,2,1326140,1321246,4894
9337881,188.277,17.6378,5158,5840,0.915975,0,2,1326404,1321246,5158
9337881,190.243,15.4331,5362,5840,0.840228,0,2,1326608,1321246,5362
9351021,268.462,749.254,292,29200,0.74895,0,1,1327424,1327132,292
9353941,252.905,673.597,292,25893,0.674081,0,1,1327568,1327276,292
9364161,239.291,607.398,292,25893,0.603571,0,1,1327712,1327420,292
9383141,230.38,549.473,316,25893,0.539375,0,1,1327880,1327564,316
9386061,233.083,498.789,424,25893,0.475703,0,1,1328132,1327708,424
9388981,236.947,472.44,400,24393,0.42249,0,1,1328396,1327996,400
9391901,243.329,449.385,400,23014,0.379679,0,1,1328684,1328284,400
9394821,249.538,429.212,405,17576,0.343469,0,1,1328977,1328572,405
9396281,265.845,417.31,451,16794,0.314285,0,1,1329357,1328906,451
9397741,258.115,388.897,465,16195,0.28875,0,1,1329561,1329096,465
9400661,251.85,364.035,483,15704,0.266406,0,1,1329769,1329286,483
9403581,266.869,366.03,475,15305,0.256855,0,1,1330141,1329666,475
9405041,287.011,367.776,523,14937,0.268498,0,2,1330569,1330046,523
9406501,281.134,345.554,573,14707,0.288686,0,2,1330809,1330236,573
9407961,272.992,326.11,599,16167,0.32135,0,2,1331025,1330426,599
9409421,268.868,309.096,649,17473,0.359931,0,2,1331265,1330616,649
9410881,263.76,294.209,687,17473,0.41369,0,2,1331493,1330806,687
9413801,259.79,281.183,729,17473,0.473229,0,2,1331725,1330996,729
9424021,289.821,261.125,1129,17313,0.727314,0,2,1333341,1332212,1129
9425481,221.096,97.1862,2403,8760,0.892553,0,2,1334767,1332364,2403
9428401,220.459,289.413,984,8760,0.894734,0,2,1334983,1333999,984
9428401,259.112,7.86566,7548,7300,0.970889,0,2,1341547,1333999,7548
9473661,255.223,877.257,813,8760,0.933278,0,2,1341775,1340962,813
9473661,248.82,767.6,1017,10220,0.902868,0,2,1341979,1340962,1017
9473661,247.718,671.65,1257,10220,0.86626,0,2,1342219,1340962,1257
9476581,249.753,662.319,924,10220,0.834227,0,2,1342483,1341559,924
9478041,263.034,636.529,824,13140,0.793699,0,2,1342839,1342015,824
9479501,255.655,585.463,800,14600,0.765736,0,2,1343043,1342243,800
9482421,246.698,540.78,756,15893,0.736269,0,2,1343227,1342471,756
9483881,270.861,530.183,740,15739,0.715486,0,2,1343667,1342927,740
9485341,264.003,492.41,728,15572,0.7048,0,2,1343883,1343155,728
9486801,267.003,459.359,788,15419,0.71045,0,2,1344171,1343383,788
9488261,259.127,430.439,764,15380,0.722894,0,2,1344375,1343611,764
9489721,261.236,405.134,812,15304,0.746282,0,2,1344651,1343839,812
9505781,242.705,257.993,1096,18224,0.939096,0,2,1347351,1346255,1096
9540821,239.512,381.558,880,18980,0.9881,0,2,1355395,1354515,880
9545201,239.573,344.989,1031,20440,0.959587,0,2,1355635,1354604,1031
9545201,238.127,301.865,1259,21900,0.948389,0,2,1355863,1354604,1259
9545201,228.736,264.132,1422,21900,0.93109,0,2,1356026,1354604,1422
9545201,204.644,231.115,1458,21900,0.913454,0,2,1356062,1354604,1458
9545201,180.563,202.226,1470,23360,0.903022,0,2,1356074,1354604,1470
9545201,159.493,176.948,1482,24820,0.896395,0,2,1356086,1354604,1482
9545201,141.056,154.829,1494,26280,0.888095,0,2,1356098,1354604,1494
9545201,129.424,135.476,1542,27740,0.878333,0,2,1356146,1354604,1542
9545201,123.746,118.541,1626,29200,0.869792,0,2,1356230,1354604,1626
9545201,117.278,103.723,1698,30660,0.864818,0,2,1356302,1354604,1698
9545201,108.618,90.7581,1746,32120,0.862965,0,2,1356350,1354604,1746
9545201,108.541,79.4133,1854,33580,0.858845,0,2,1356458,1354604,1854
9545201,99.4733,69.4866,1890,35040,0.855239,0,2,1356494,1354604,1890
9545201,94.5391,60.8008,1950,36500,0.854584,0,2,1356554,1354604,1950
9545201,94.7218,53.2007,2046,37960,0.854011,0,2,1356650,1354604,2046
9545201,97.8815,46.5506,2166,39420,0.85851,0,2,1356770,1354604,2166
9545201,96.1463,40.7318,2250,40880,0.864946,0,2,1356854,1354604,2250
9545201,91.628,35.6403,2310,41515,0.878078,0,2,1356914,1354604,2310
9545201,89.1745,31.1853,2382,41515,0.884568,0,2,1356986,1354604,2382
9545201,90.0277,27.2871,2478,42138,0.897747,0,2,1357082,1354604,2478
9545201,86.2743,23.8762,2538,42138,0.909279,0,2,1357142,1354604,2538
9545201,84.49,20.8917,2610,1460,0.919369,0,2,1357214,1354604,2610
9594841,154.738,74.6673,2807,8760,0.993867,0,2,1359962,1357155,2807
9594841,163.895,65.3339,3035,10220,0.989634,0,2,1360190,1357155,3035
9594841,171.909,57.1672,3263,11680,0.98843,0,2,1360418,1357155,3263
9639201,267.44,295.759,1105,18677,0.994464,0,2,1367872,1366767,1105
9640661,262.51,286.04,1115,18677,0.993906,0,2,1368100,1366985,1115
9643581,255.696,276.91,1110,18677,0.983417,0,2,1368308,1367198,1110
9645041,274.234,295.546,1088,20142,0.95174,0,2,1368712,1367624,1088
9646501,265.455,285.228,1079,21602,0.921523,0,2,1368916,1367837,1079
9649421,249.273,276.199,1002,22711,0.895082,0,2,1369052,1368050,1002
9652341,254.114,294.924,864,22711,0.866947,0,2,1369340,1368476,864
9655261,262.85,305.059,812,22711,0.832329,0,2,1369664,1368852,812
9658181,267.493,306.176,798,22816,0.794538,0,2,1369964,1369166,798
9661101,262.557,307.154,712,24401,0.76397,0,2,1370192,1369480,712
9664021,265.737,308.01,686,23849,0.747224,0,2,1370480,1369794,686
9666941,277.52,308.509,734,23314,0.750071,0,2,1370840,1370106,734
9669861,281.83,304.695,768,22946,0.775062,0,2,1371152,1370384,768
9680081,244.189,101.753,2596,8760,0.950944,0,2,1374092,1371496,2596
9680081,242.166,89.0339,2824,1460,0.954576,0,2,1374320,1371496,2824
9697601,239.574,129.207,2629,11680,0.983351,0,2,1377332,1374703,2629
9718041,226.595,354.677,1061,13140,0.990962,0,2,1378868,1377807,1061
9718041,228.271,310.342,1301,14600,0.989592,0,2,1379108,1377807,1301
9735561,212.026,283.82,1323,5840,0.971096,0,2,1381976,1380653,1323
9735561,214.023,248.342,1551,5840,0.947209,0,2,1382204,1380653,1551
9741401,362.77,549.55,297,1460,0.842558,0,1,1383608,1383311,297
9742861,354.924,517.981,300,18980,0.750988,0,1,1383908,1383608,300
9745781,319.558,465.983,270,20440,0.670864,0,1,1383980,1383710,270
9748701,312.613,420.485,432,21900,0.613256,0,1,1384244,1383812,432
9751621,302.037,393.425,456,24820,0.567849,0,1,1384472,1384016,456
9754541,291.282,369.747,468,27740,0.540618,0,2,1384688,1384220,468
9757461,283.372,349.028,492,30660,0.531791,0,2,1384916,1384424,492
9760381,282.45,330.9,564,29943,0.539067,0,2,1385192,1384628,564
9763301,269.644,312.412,561,29285,0.552934,0,2,1385372,1384811,561
9766221,262.939,293.611,615,28712,0.575067,0,2,1385588,1384973,615
9769141,258.571,277.159,681,28397,0.614434,0,2,1385816,1385135,681
9772061,248.75,262.764,699,28369,0.658879,0,2,1385996,1385297,699
9788121,188.846,62.3031,2619,11680,0.945221,0,2,1388888,1386269,2619
9814401,252.094,63.7914,4484,5840,0.980278,0,2,1396292,1391808,4484
9814401,250.582,55.8174,4724,5840,0.937743,0,2,1396532,1391808,4724
9824621,468.26,828.34,480,17520,0.899275,0,2,1398524,1398044,480
9829001,418.727,737.298,452,18980,0.870616,0,2,1398596,1398144,452
9842141,390.386,657.636,544,20440,0.858039,0,2,1398788,1398244,544
9845061,371.588,587.931,684,20774,0.869534,0,2,1399028,1398344,684
9855281,241.821,160.64,2350,11680,0.967472,0,2,1401812,1399462,2350
9855281,241.594,140.56,2590,13140,0.952788,0,2,1402052,1399462,2590
9855281,241.394,122.99,2830,14600,0.952439,0,2,1402292,1399462,2830
9878641,212.082,318.921,1131,14600,0.981158,0,2,1403816,1402685,1131
9896161,226.3,306.011,1210,13140,0.989179,0,2,1406804,1405594,1210
9896161,228.013,267.759,1450,13140,0.986782,0,2,1407044,1405594,1450
9912221,221.11,305.982,1323,5840,0.982962,0,2,1409960,1408637,1323
9912221,223.471,267.734,1563,5840,0.966341,0,2,1410200,1408637,1563
9912221,293.037,234.268,2343,5840,0.941799,0,2,1410980,1408637,2343
9912221,343.408,204.984,3039,1460,0.930324,0,2,1411676,1408637,3039
9912221,327.482,179.361,3255,5840,0.925283,0,2,1411892,1408637,3255
9912221,318.046,156.941,3507,7300,0.928373,0,2,1412144,1408637,3507
9916601,279.791,483.698,748,8760,0.931076,0,2,1412156,1411408,748
9931201,225.528,123.735,2500,10220,0.988121,0,2,1415336,1412836,2500
9934121,240.432,423.532,1092,10220,0.989669,0,2,1416872,1415780,1092
9934121,202.928,97.4932,3315,8760,0.996372,0,2,1419095,1415780,3315
9985221,183.39,211.556,1685,5840,0.992332,0,2,1423444,1421759,1685
9985221,187.466,185.112,1901,5840,0.97829,0,2,1423660,1421759,1901
9985221,176.033,161.973,1997,5840,0.962254,0,2,1423756,1421759,1997
9985221,155.529,141.726,2009,5840,0.945722,0,2,1423768,1421759,2009
9985221,142.088,124.01,2057,5840,0.931257,0,2,1423816,1421759,2057
9985221,136.327,108.509,2153,5840,0.9186,0,2,1423912,1421759,2153
9985221,210.786,94.9454,2885,1460,0.888775,0,2,1424644,1421759,2885
9995441,252.313,432.202,635,24820,0.866428,0,2,1425187,1424552,635
9996901,232.774,389.677,639,26280,0.856875,0,2,1425283,1424644,639
10008581,211.177,349.967,627,27740,0.846015,0,2,1425343,1424716,627
10011501,204.28,315.221,711,29200,0.844013,0,2,1425499,1424788,711
10014421,193.745,293.819,687,32120,0.842262,0,2,1425619,1424932,687
10017341,193.527,275.091,735,35040,0.853229,0,2,1425811,1425076,735
10053841,252.465,30.4222,5832,17520,0.998279,0,2,1437247,1431415,5832
10053841,267.407,26.6194,6204,16676,0.977244,0,2,1437619,1431415,6204
10084501,280.481,738.417,855,16676,0.958839,0,2,1437991,1437136,855
10091801,270.921,675.115,827,16676,0.935234,0,2,1438195,1437368,827
10091801,255.056,590.725,971,18136,0.90708,0,2,1438339,1437368,971
10093261,272.174,574.885,899,18136,0.884945,0,2,1438731,1437832,899
10094721,263.652,532.024,871,19545,0.860577,0,2,1438935,1438064,871
10096181,256.196,494.521,843,19457,0.841754,0,2,1439139,1438296,843
10099101,251.671,455.831,878,19331,0.832785,0,2,1439359,1438481,878
10100561,263.212,445.102,852,19406,0.844937,0,2,1439703,1438851,852
10103481,254.811,412.589,863,19317,0.86307,0,2,1439899,1439036,863
10113701,252.352,174.303,2194,8760,0.952727,0,2,1442611,1440417,2194
10113701,250.808,152.515,2434,8760,0.933636,0,2,1442851,1440417,2434
10113701,249.457,133.451,2674,10220,0.938182,0,2,1443091,1440417,2674
10148741,208.292,160.991,2010,13140,0.992806,0,2,1448659,1446649,2010
10148741,212.256,140.867,2250,13140,0.989955,0,2,1448899,1446649,2250
10158961,211.414,323.834,1271,5840,0.987305,0,2,1450375,1449104,1271
10163341,373.176,555.935,535,17520,0.916531,0,2,1452103,1451568,535
10166261,340.029,499.443,539,18980,0.850714,0,2,1452211,1451672,539
10175021,306.526,450.013,507,20440,0.795625,0,2,1452283,1451776,507
10177941,293.71,406.761,607,21900,0.757422,0,2,1452487,1451880,607
10180861,276.496,381.916,555,24820,0.726494,0,2,1452643,1452088,555
10183781,267.434,357.552,572,27740,0.704432,0,2,1452847,1452275,572
10186701,259.505,333.608,610,30660,0.700128,0,2,1453051,1452441,610
10189621,252.567,312.657,648,31501,0.703862,0,2,1453255,1452607,648
10192541,243.496,294.325,662,30911,0.71713,0,2,1453435,1452773,662
10195461,240.059,278.284,712,30434,0.748738,0,2,1453651,1452939,712
10211521,231.613,301.357,924,10220,0.945642,0,2,1456399,1455475,924
10230501,268.472,74.8053,3444,7300,0.992586,0,2,1460971,1457527,3444
10230501,228.924,25.7038,5052,17520,0.994953,0,2,1462579,1457527,5052
10253861,225.245,483.076,1584,5840,0.974922,0,2,1464799,1463215,1584
10253861,212.089,422.692,1704,5840,0.939307,0,2,1464919,1463215,1704
10268461,325.078,674.855,380,1460,0.848144,0,1,1466035,1465655,380
10271381,347.443,637.999,504,21900,0.778376,0,1,1466539,1466035,504
10274301,341.513,592.249,532,22736,0.732329,0,2,1466839,1466307,532
10277221,340.824,552.218,596,21985,0.724538,0,2,1467175,1466579,596
10278681,342.721,517.19,680,17043,0.73772,0,2,1467531,1466851,680
10281601,322.881,469.542,728,16900,0.766755,0,2,1467715,1466987,728
10300581,238.326,323.296,924,8760,0.950143,0,2,1470691,1469767,924
10300581,232.43,145.094,2316,13140,0.971374,0,2,1472083,1469767,2316
10302041,233.376,343.457,824,14600,0.972453,0,2,1472323,1471499,824
10331241,199.081,107.633,2484,13140,0.993882,0,2,1477615,1475131,2484
10331241,194.919,55.2058,3468,20440,0.991862,0,2,1478599,1475131,3468
10331241,199.054,48.3051,3696,21900,0.972879,0,2,1478827,1475131,3696
10345841,201.172,429.267,816,23360,0.94627,0,2,1479043,1478227,816
10348761,200.026,395.609,848,24820,0.916736,0,2,1479235,1478387,848
10356061,187.022,362.158,816,22739,0.893394,0,2,1479331,1478515,816
10356061,178.645,316.888,936,22739,0.86047,0,2,1479451,1478515,936
10358981,178.814,309.277,860,22739,0.829161,0,2,1479631,1478771,860
10361901,177.462,302.617,772,22520,0.806766,0,2,1479799,1479027,772
10364821,191.279,296.79,804,22118,0.79217,0,2,1480087,1479283,804
10367741,209.37,306.316,767,24035,0.786899,0,2,1480423,1479656,767
10370661,226.698,308.027,795,23665,0.789786,0,2,1480771,1479976,795
10373581,238.861,307.273,817,23418,0.797313,0,2,1481095,1480278,817
10407161,235.72,301.114,1289,13140,0.985741,0,2,1487419,1486130,1289
10431981,201.236,108.159,2697,5840,0.998089,0,2,1491967,1489270,2697
10448041,162.1,296.085,1167,33580,0.994425,0,2,1493191,1492024,1167
10448041,165.837,259.075,1359,33580,0.992622,0,2,1493383,1492024,1359
10448041,241.5,4.12738,7227,10220,0.993632,0,2,1499251,1492024,7227
10448041,254.944,1.85235,8787,17520,0.995892,0,2,1500811,1492024,8787
10448041,220.88,0.72741,10179,27740,0.994637,0,2,1502203,1492024,10179
10448041,167.503,0.167443,11763,30231,0.997515,0,2,1503787,1492024,11763
10448041,196.401,0.0657543,13299,10220,0.996524,0,2,1505323,1492024,13299
10448041,179.523,0.0225938,14643,21900,0.987556,0,2,1506667,1492024,14643
10448041,181.083,0.0197695,14835,23360,0.966611,0,2,1506859,1492024,14835
10448041,185.447,0.0172983,15051,24820,0.959535,0,2,1507075,1492024,15051
10448041,178.766,0.015136,15183,26280,0.955843,0,2,1507207,1492024,15183
10448041,166.921,0.013244,15267,26692,0.955113,0,2,1507291,1492024,15267
10448041,167.055,0.0115885,15435,26692,0.956974,0,2,1507459,1492024,15435
10448041,160.064,0.00679299,16035,26692,0.969779,0,2,1508059,1492024,16035
10583261,1118.39,2297.54,1178,10220,0.964382,0,2,1520338,1519160,1178
10584721,1008.59,2062.1,1004,11680,0.936334,0,2,1520578,1519574,1004
10586181,912.516,1821.09,1110,13140,0.905543,0,2,1520818,1519708,1110
10586181,800.452,1593.45,1126,14600,0.87985,0,2,1520834,1519708,1126
10586181,724.395,1394.27,1318,16060,0.863619,0,2,1521026,1519708,1318
10586181,642.846,1219.99,1390,17520,0.856916,0,2,1521098,1519708,1390
10586181,569.99,1067.49,1450,11680,0.846052,0,2,1521158,1519708,1450
10586181,506.241,934.051,1510,11680,0.839045,0,2,1521218,1519708,1510
10586181,454.961,817.295,1606,11680,0.837915,0,2,1521314,1519708,1606
10586181,408.591,715.133,1690,13140,0.841925,0,2,1521398,1519708,1690
10586181,369.517,625.741,1786,14600,0.847935,0,2,1521494,1519708,1786
10586181,339.827,547.524,1918,16060,0.858193,0,2,1521626,1519708,1918
10586181,307.849,479.083,2002,17520,0.859669,0,2,1521710,1519708,2002
10602241,282.868,592.948,720,18980,0.86846,0,2,1521818,1521098,720
10605161,271.509,526.329,852,5840,0.873653,0,2,1522010,1521158,852
10608081,275.071,494.038,884,8760,0.883196,0,2,1522310,1521426,884
10618301,231.791,138.409,2624,1460,0.973974,0,2,1525154,1522530,2624
10643121,172.818,86.8825,2543,1460,0.982647,0,2,1528190,1525647,2543
10659181,192.228,250.575,1395,13140,0.989436,0,2,1529618,1528223,1395
10679621,230.317,290.573,996,14600,0.973818,0,2,1532366,1531370,996
10679621,231.527,254.252,1236,16060,0.967091,0,2,1532606,1531370,1236
10679621,200.36,87.3631,2616,24820,0.968692,0,2,1533986,1531370,2616
10679621,208.315,76.4427,2880,26280,0.971356,0,2,1534250,1531370,2880
10713201,106.892,24.9327,2548,5840,0.995088,0,2,1536945,1534397,2548
10730721,158.193,74.4566,2262,1460,0.98966,0,2,1539873,1537611,2262
10768681,213.745,312.121,1299,13140,0.997529,0,2,1543547,1542248,1299
10768681,228.827,140.078,2763,5840,0.996391,0,2,1545011,1542248,2763
10795261,262.423,339.147,1096,5840,0.971635,0,2,1546219,1545123,1096
10796721,258.12,313.253,1192,5840,0.94768,0,2,1546447,1545255,1192
10798181,254.355,306.597,1160,5840,0.94047,0,2,1546675,1545515,1160
10809861,175.251,64.4491,2608,13140,0.98885,0,2,1549703,1547095,2608
10812781,205.565,149.98,2532,20440,0.995535,0,2,1552451,1549919,2532
10847821,196.862,341.279,1002,13140,0.990747,0,2,1553809,1552807,1002
10847821,200.754,298.619,1230,14600,0.975653,0,2,1554037,1552807,1230
10847821,201.16,261.292,1434,16060,0.972447,0,2,1554241,1552807,1434
10847821,195.515,228.631,1590,17520,0.972141,0,2,1554397,1552807,1590
10847821,186.076,200.052,1710,18980,0.974373,0,2,1554517,1552807,1710
10910601,184.523,136.981,2354,13140,0.991195,0,2,1564228,1561874,2354
10910601,194.457,119.858,2618,1460,0.984796,0,2,1564492,1561874,2618
10925201,194.895,100.437,2701,1460,0.995155,0,2,1567372,1564671,2701
10925201,200.533,87.8821,2941,5840,0.993261,0,2,1567612,1564671,2941
10957321,154.15,248.15,1063,18980,0.996977,0,2,1568920,1567857,1063
10957321,160.849,85.2667,2383,5840,0.987711,0,2,1570240,1567857,2383
10957321,169.243,74.6084,2611,5840,0.976747,0,2,1570468,1567857,2611
10987981,207.082,335.292,1289,13140,0.995018,0,2,1575064,1573775,1289
11015721,229.472,373.324,1257,13140,0.988573,0,2,1580632,1579375,1257
11015721,180.011,98.2125,2781,5840,0.989494,0,2,1582156,1579375,2781
11091641,205.263,123.172,2661,23360,0.994956,0,2,1591048,1588387,2661
11125221,233.6,264.23,1312,23360,0.986611,0,2,1593936,1592624,1312
11125221,209.4,231.201,1352,24820,0.982035,0,2,1593976,1592624,1352
11128141,228.574,125.986,2580,1460,0.995644,0,2,1597024,1594444,2580
11154421,203.64,233.077,1305,16060,0.997253,0,2,1598572,1597267,1305
11167561,202.221,35.5178,4419,30819,0.997462,0,2,1604500,1600081,4419
11167561,204.862,5.4772,7119,13140,0.994609,0,2,1607200,1600081,7119
11167561,209.254,4.79255,7359,14600,0.989033,0,2,1607440,1600081,7359
11167561,226.331,1.88202,9003,24820,0.989443,0,2,1609084,1600081,9003
11231801,215.244,1033.48,1229,14600,0.996861,0,2,1613572,1612343,1229
11293121,237.701,421.782,1166,14600,0.995766,0,2,1616796,1615630,1166
11293121,212.64,165.632,2466,10220,0.988337,0,2,1618096,1615630,2466
11313561,212.33,115.113,2544,1460,0.993426,0,2,1621204,1618660,2544
11328161,212.139,120.871,2472,21900,0.982591,0,2,1624036,1621564,2472
11328161,215.622,105.762,2712,1460,0.971018,0,2,1624276,1621564,2712
11407001,209.611,292.093,1200,14600,0.982445,0,2,1634464,1633264,1200
11409921,205.312,177.307,1788,13140,0.984622,0,2,1635748,1633960,1788
11409921,208.148,155.143,2016,13140,0.961544,0,2,1635976,1633960,2016
11411381,215.13,329.25,732,13140,0.956351,0,2,1636240,1635508,732
11418681,227.239,318.094,804,13140,0.950557,0,2,1636552,1635748,804
11418681,225.834,278.332,1020,13140,0.942987,0,2,1636768,1635748,1020
11418681,230.605,243.541,1284,14600,0.943864,0,2,1637032,1635748,1284
11418681,239.279,213.098,1584,14600,0.947131,0,2,1637332,1635748,1584
11437661,156.504,75.7574,2027,10220,0.985221,0,2,1640116,1638089,2027
11437661,165.441,66.2877,2255,10220,0.980818,0,2,1640344,1638089,2255
11439121,173.688,77.0978,2376,20440,0.992983,0,2,1641796,1639420,2376
11466861,175.191,320.054,1092,14600,0.993839,0,2,1643164,1642072,1092
11466861,180.104,96.2267,2712,1460,0.993148,0,2,1644784,1642072,2712
11503361,161.693,49.1337,2907,5840,0.992222,0,2,1649200,1646293,2907
11560301,194.087,227.425,1124,20440,0.979724,0,2,1653984,1652860,1124
11560301,171.826,198.997,1140,21900,0.962258,0,2,1654000,1652860,1140
11560301,172.848,174.123,1320,23360,0.959476,0,2,1654180,1652860,1320
11560301,170.742,152.357,1476,24820,0.948292,0,2,1654336,1652860,1476
11560301,153.274,133.313,1507,5320,0.943505,0,2,1654367,1652860,1507
11563221,225.99,301.149,766,2400,0.924317,0,2,1655102,1654336,766
11564681,286.241,359.255,708,5840,0.912527,0,2,1655810,1655102,708
11570001,269.961,333.348,712,5840,0.899711,0,2,1655966,1655254,712
11580221,431.534,430.656,1140,14600,0.950617,0,2,1660843,1659703,1140
11581681,406.092,395.824,1216,16060,0.95179,0,2,1661071,1659855,1216
11581681,358.83,346.346,1244,17520,0.952816,0,2,1661099,1659855,1244
11599201,258.882,341.461,1167,11680,0.982996,0,2,1663835,1662668,1167
11616721,289.438,338.986,1178,11680,0.994075,0,2,1666963,1665785,1178
11616721,258.258,296.612,1218,13140,0.992316,0,2,1667003,1665785,1218
11616721,250.921,152.135,2442,7300,0.994809,0,2,1668227,1665785,2442
11616721,249.555,133.118,2682,1460,0.955458,0,2,1668467,1665785,2682
11616721,248.361,116.478,2922,5840,0.929775,0,2,1668707,1665785,2922
11616721,241.316,101.919,3114,7300,0.902303,0,2,1668899,1665785,3114
11616721,227.651,89.1788,3246,8760,0.878266,0,2,1669031,1665785,3246
11632781,208.195,399.781,744,10220,0.854732,0,2,1669103,1668359,744
11632781,201.671,349.809,900,11680,0.844141,0,2,1669259,1668359,900
11632781,197.462,306.083,1068,11680,0.844873,0,2,1669427,1668359,1068
11632781,198.279,267.822,1272,11680,0.850514,0,2,1669631,1668359,1272
11635701,221.494,335.345,848,5840,0.86045,0,2,1670015,1669167,848
11645921,229.094,121.185,2472,8760,0.960642,0,2,1673135,1670663,2472
11664901,220.267,282.768,1050,11680,0.980794,0,2,1674635,1673585,1050
11675121,225.353,155.859,2028,11680,0.994538,0,2,1677659,1675631,2028
11678041,214.24,132.564,2208,11680,0.987855,0,2,1679111,1676903,2208
11678041,263.766,67.9931,3744,16060,0.987521,0,2,1680647,1676903,3744
11678041,260.795,59.494,3984,17520,0.987831,0,2,1680887,1676903,3984
11678041,267.196,52.0572,4296,1460,0.985602,0,2,1681199,1676903,4296
11678041,263.796,45.5501,4536,5840,0.981152,0,2,1681439,1676903,4536
11678041,242.822,39.8563,4632,5840,0.977258,0,2,1681535,1676903,4632
11678041,228.969,34.8743,4764,5840,0.97135,0,2,1681667,1676903,4764
11678041,213.848,30.515,4872,5840,0.963682,0,2,1681775,1676903,4872
11689721,196.117,538.201,852,5840,0.949471,0,2,1681847,1680995,852
11691181,192.602,496.426,816,5840,0.939538,0,2,1682015,1681199,816
11702861,185.027,450.372,820,5840,0.920845,0,2,1682147,1681327,820
11713081,173.899,410.076,788,5840,0.91199,0,2,1682243,1681455,788
11716001,218.161,407.816,924,20440,0.904241,0,2,1682771,1681847,924
11718921,220.891,394.339,864,23360,0.892461,0,2,1683011,1682147,864
11721841,220.28,373.797,850,26280,0.884653,0,2,1683227,1682377,850
11724761,221.245,352.572,874,29200,0.875322,0,2,1683455,1682581,874
11727681,213.089,334.001,826,32120,0.874656,0,2,1683611,1682785,826
11730601,210.453,317.751,814,35040,0.879074,0,2,1683803,1682989,814
11733521,209.646,303.532,814,34633,0.87044,0,2,1684007,1683193,814
11736441,208.941,291.09,814,34119,0.875385,0,2,1684211,1683397,814
11756881,184.093,23.9624,4056,14600,0.993695,0,2,1688759,1684703,4056
11761261,227.799,749.826,1120,11680,0.99248,0,2,1691783,1690663,1120
11761261,231.466,294.454,2740,1460,0.987047,0,2,1693403,1690663,2740
11810901,209.464,208.057,2195,5840,0.988268,0,2,1695695,1693500,2195
11810901,282.281,182.05,2987,1460,0.940985,0,2,1696487,1693500,2987
11813821,273.996,469.669,720,21900,0.904612,0,2,1696703,1695983,720
11818201,287.746,473.96,600,23360,0.870285,0,2,1697087,1696487,600
11825501,268.278,429.715,612,24820,0.85275,0,2,1697219,1696607,612
11828421,266.243,391.001,744,26280,0.834906,0,2,1697471,1696727,744
11831341,261.463,372.126,732,29200,0.826793,0,2,1697699,1696967,732
11834261,260.28,355.61,744,30440,0.824694,0,2,1697951,1697207,744
11837181,265.245,341.159,804,29953,0.832857,0,2,1698251,1697447,804
11840101,256.089,325.514,780,29710,0.8425,0,2,1698443,1697663,780
11843021,252.578,308.825,816,29418,0.858437,0,2,1698671,1697855,816
11872221,213.546,273.749,1080,11680,0.988953,0,2,1702979,1701899,1080
11902881,205.48,215.628,1734,5840,0.996096,0,2,1709327,1707593,1734
11902881,205.295,188.675,1938,5840,0.975334,0,2,1709531,1707593,1938
11902881,191.633,165.09,2034,5840,0.957167,0,2,1709627,1707593,2034
11902881,185.679,144.454,2178,5840,0.921271,0,2,1709771,1707593,2178
11902881,181.969,126.397,2334,5840,0.889862,0,2,1709927,1707593,2334
11917481,259.723,431.348,572,24820,0.83238,0,2,1710731,1710159,572
11918941,242.258,400.929,504,19569,0.782082,0,2,1710851,1710347,504
11920401,231.475,374.313,472,19569,0.740572,0,2,1711007,1710535,472
11933541,228.041,351.024,488,19569,0.70425,0,2,1711211,1710723,488
11935001,245.536,330.646,668,21029,0.694969,0,2,1711579,1710911,668
11936461,243.344,312.815,708,21976,0.689348,0,2,1711807,1711099,708
11939381,232.926,297.213,680,21604,0.704429,0,2,1711967,1711287,680
11942301,254.81,297.562,788,21231,0.737626,0,2,1712375,1711587,788
11964201,228.928,156.378,2623,18980,0.984356,0,2,1718171,1715548,2623
11970041,230.623,77.4816,3816,11680,0.993586,0,2,1722215,1718399,3816
11999241,461.952,776.782,585,21364,0.971953,0,2,1724783,1724198,585
12002161,438.708,709.309,624,16361,0.959209,0,2,1725059,1724435,624
12016761,281.619,196.552,2380,7300,0.981784,0,2,1728143,1725763,2380
12043041,219.065,47.7603,3962,11680,0.998255,0,2,1734323,1730361,3962
12043041,245.839,21.4346,5534,5840,0.989217,0,2,1735895,1730361,5534
12043041,243.609,18.7553,5762,5840,0.978065,0,2,1736123,1730361,5762
12043041,243.158,16.4109,6002,20555,0.969557,0,2,1736363,1730361,6002
12070781,295.263,743.86,826,22015,0.944612,0,2,1737023,1736197,826
12073701,277.855,672.877,806,22695,0.920286,0,2,1737179,1736373,806
12076621,261.123,610.767,774,22695,0.894,0,2,1737323,1736549,774
12079541,261.483,556.422,862,22695,0.866,0,2,1737587,1736725,862
12082461,269.298,530.869,834,22297,0.8315,0,2,1737911,1737077,834
12085381,274.635,508.51,794,21882,0.801312,0,2,1738223,1737429,794
12088301,277.806,488.946,742,21434,0.774898,0,2,1738523,1737781,742
12091221,283.58,471.828,714,20937,0.771786,0,2,1738847,1738133,714
12092681,300.133,456.85,778,20439,0.786563,0,2,1739263,1738485,778
12094141,292.616,421.743,842,20140,0.811992,0,2,1739503,1738661,842
12105821,243.441,145.726,2255,8760,0.955882,0,2,1742327,1740072,2255
12105821,243.011,127.51,2495,8760,0.946397,0,2,1742567,1740072,2495
12156921,266.083,360.16,1172,16060,0.994024,0,2,1749871,1748699,1172
12158381,262.823,339.14,1220,5840,0.987271,0,2,1750111,1748891,1220
12158381,234.97,296.748,1260,5840,0.978862,0,2,1750151,1748891,1260
12158381,234.099,259.654,1488,5840,0.967754,0,2,1750379,1748891,1488
12158381,234.836,227.198,1728,5840,0.948035,0,2,1750619,1748891,1728
12158381,275.982,198.798,2292,4380,0.900781,0,2,1751183,1748891,2292
12161301,260.984,389.948,720,19768,0.854433,0,2,1751339,1750619,720
12167141,280.861,411.705,576,19768,0.813879,0,2,1751759,1751183,576
12170061,283.253,379.367,723,5840,0.793394,0,2,1752059,1751336,723
12172981,288.347,370.196,741,8760,0.79047,0,2,1752383,1751642,741
12175901,313.803,376.046,816,11680,0.800411,0,2,1752875,1752059,816
12189041,258.625,135.346,2442,8760,0.953549,0,2,1756031,1753589,2442
12243061,217.396,277.577,1032,10220,0.998183,0,2,1763603,1762571,1032
12244521,245.222,281.129,1166,11680,0.99716,0,2,1764043,1762877,1166
12244521,210.123,215.24,1350,5840,0.984076,0,2,1764227,1762877,1350
12244521,212.358,188.335,1578,5840,0.962317,0,2,1764455,1762877,1578
12244521,211.313,164.793,1782,4380,0.928277,0,2,1764659,1762877,1782
12244521,226.899,144.194,2118,4380,0.893492,0,2,1764995,1762877,2118
12253281,221.036,323.42,720,19096,0.863056,0,2,1765175,1764455,720
12254741,236.407,310.992,840,5840,0.838924,0,2,1765519,1764679,840
12256201,244.356,311.618,824,7300,0.830308,0,2,1765819,1764995,824
12257661,242.311,300.666,828,8760,0.83777,0,2,1766047,1765219,828
12269341,252.205,146.747,2092,7300,0.941074,0,2,1769103,1767011,2092
12269341,249.179,128.403,2320,8760,0.94344,0,2,1769331,1767011,2320
12294161,247.638,256.086,1161,18980,0.987532,0,2,1772471,1771310,1161
12295621,213.361,110.606,2258,7300,0.980104,0,2,1773747,1771489,2258
12305841,215.191,292.03,924,8760,0.967591,0,2,1773975,1773051,924
12321901,220.617,264.696,1081,8760,0.99129,0,2,1776299,1775218,1081
12323361,221.54,256.984,1106,10220,0.991128,0,2,1776527,1775421,1106
12326281,239.851,268.035,1093,5840,0.978208,0,2,1777140,1776047,1093
12327741,238.37,257.03,1141,5840,0.953432,0,2,1777368,1776227,1141
12329201,237.073,247.401,1189,5840,0.918003,0,2,1777596,1776407,1189
12329201,210.939,216.476,1217,5840,0.887002,0,2,1777624,1776407,1217
12329201,246.072,189.417,1709,5840,0.832377,0,2,1778116,1776407,1709
12329201,230.313,165.74,1829,22645,0.77708,0,2,1778236,1776407,1829
12329201,213.524,145.022,1925,4380,0.726195,0,2,1778332,1776407,1925
12329201,222.833,126.894,2213,4380,0.676671,0,2,1778620,1776407,2213
12337961,205.479,339.658,468,5840,0.633337,0,2,1778704,1778236,468
12339421,215.294,309.2,656,5840,0.58542,0,1,1778988,1778332,656
12342341,215.882,306.55,588,7300,0.543492,0,1,1779208,1778620,588
12345261,229.397,313.232,552,10220,0.509306,0,1,1779532,1778980,552
12348181,245.722,319.078,552,13140,0.481892,0,1,1779892,1779340,552
12351101,263.007,324.193,576,16060,0.467906,0,2,1780276,1779700,576
12354021,278.131,328.669,600,18866,0.458168,0,2,1780660,1780060,600
12355481,295.365,332.585,656,18363,0.467147,0,2,1781076,1780420,656
12356941,283.944,313.512,680,18038,0.480003,0,2,1781280,1780600,680
12359861,274.451,296.823,708,17811,0.498753,0,2,1781488,1780780,708
12361321,292.145,304.72,764,17665,0.530159,0,2,1781904,1781140,764
12364241,281.627,289.13,792,17649,0.567639,0,2,1782112,1781320,792
12365701,296.923,297.989,836,20569,0.610434,0,2,1782516,1781680,836
12416801,207.306,376.7,1063,11680,0.985842,0,2,1789756,1788693,1063
12416801,209.893,329.612,1291,13140,0.968862,0,2,1789984,1788693,1291
12431401,204.825,352.798,947,5840,0.985198,0,2,1792708,1791761,947
12432861,198.722,331.324,922,5840,0.975798,0,2,1792864,1791942,922
12441621,240.909,323.16,980,20440,0.982537,0,2,1793844,1792864,980
12453301,237.557,128.324,2420,13140,0.98848,0,2,1796572,1794152,2420
12467901,243.47,333.427,1234,11680,0.992976,0,2,1798324,1797090,1234
1302481,188.574,123.77,2330,10220,0.990323,0,2,52676,50346,2330
1379861,291.658,343.079,2553,7300,0.987493,0,2,65876,63323,2553
1379861,232.03,117.885,4173,7300,0.994452,0,2,67496,63323,4173
1492281,213.417,139.526,2292,8760,0.995,0,2,83372,81080,2292
1492281,216.74,122.085,2532,10220,0.986875,0,2,83612,81080,2532
1492281,219.647,106.824,2772,1460,0.983515,0,2,83852,81080,2772
1492281,237.192,93.4714,3132,5840,0.984326,0,2,84212,81080,3132
1514181,227.109,321.371,1044,14600,0.992595,0,2,85648,84604,1044
1531701,264.546,291.235,1080,21703,0.991802,0,2,88444,87364,1080
1540461,248.166,250.333,1144,21342,0.990071,0,2,89848,88704,1144
1559441,210.165,282.231,1397,11680,0.98366,0,2,92852,91455,1397
1568201,247.03,297.738,1136,18980,0.985369,0,2,94336,93200,1136
1569661,243.151,282.271,1178,20440,0.979698,0,2,94552,93374,1178
1569661,217.725,216.114,1434,23124,0.983206,0,2,94808,93374,1434
1587181,206.628,287.381,1375,11680,0.995367,0,2,97297,95922,1375
1597401,224.413,194.599,1824,10220,0.977817,0,2,100057,98233,1824
1597401,226.362,170.274,2064,10220,0.96809,0,2,100297,98233,2064
1612001,199.026,271.83,1263,11680,0.985285,0,2,101725,100462,1263
1625141,220.738,318.898,864,1460,0.992036,0,2,104617,103753,864
1633901,269.478,293.901,1228,29200,0.984082,0,2,106081,104853,1228
1633901,210.05,88.3636,2872,7300,0.992714,0,2,107725,104853,2872
1660181,229.859,256.173,1217,17520,0.990889,0,2,109317,108100,1217
1660181,201.281,88.0232,2637,1460,0.994369,0,2,110737,108100,2637
1695221,248.769,322.013,1122,10220,0.995805,0,2,115149,114027,1122
1696681,219.365,120.169,2504,13140,0.997308,0,2,116725,114221,2504
1706901,225.881,335.681,1320,11680,0.991292,0,2,118117,116797,1320
1730261,263.663,364.742,1083,16921,0.982996,0,2,121053,119970,1083
1731721,259.205,352.774,1042,16878,0.981371,0,2,121281,120239,1042
1737561,268.092,318.107,1070,16466,0.98658,0,2,122385,121315,1070
1739021,266.08,311.968,1053,16466,0.977008,0,2,122637,121584,1053
1740481,258.32,306.597,988,16444,0.978632,0,2,122841,121853,988
1765301,222.185,105.447,2407,10220,0.985259,0,2,128377,125970,2407
1765301,224.412,92.2663,2647,11680,0.983352,0,2,128617,125970,2647
1790121,243.415,302.398,1130,17520,0.979147,0,2,131517,130387,1130
1791581,242.988,293.473,1139,18980,0.975503,0,2,131757,130618,1139
1806181,225.29,224.107,1432,11680,0.993816,0,2,134413,132981,1432
1813481,246.082,266.13,1106,5840,0.993078,0,2,135801,134695,1106
1814941,243.821,259.364,1122,5840,0.975193,0,2,136029,134907,1122
1816401,243.344,248.068,1193,5840,0.960794,0,2,136269,135076,1193
1817861,241.426,279.185,924,5840,0.959445,0,2,136497,135573,924
1836841,225.331,116.033,2188,7300,0.992584,0,2,140593,138405,2188
1836841,225.665,101.529,2416,8760,0.986011,0,2,140821,138405,2416
1860201,217.24,92.9402,2600,8760,0.994032,0,2,145117,142517,2600
1877721,227.776,318.498,1164,11680,0.996072,0,2,146545,145381,1164
1887941,205.681,117.331,2251,5840,0.984308,0,2,149353,147102,2251
1887941,208.471,102.665,2479,5840,0.967519,0,2,149581,147102,2479
1905461,226.456,170.534,2106,7300,0.989708,0,2,152425,150319,2106
1914221,226.769,196.555,1824,11680,0.994131,0,2,153781,151957,1824
1914221,228.423,171.986,2064,13140,0.988615,0,2,154021,151957,2064
1922981,214.084,59.2145,3544,13140,0.981994,0,2,156985,153441,3544
1990141,288.123,427.566,1253,11680,0.992387,0,2,168529,167276,1253
1990141,272.7,112.482,3797,8760,0.992997,0,2,171073,167276,3797
2031021,266.133,361.227,1151,19897,0.996946,0,2,176121,174970,1151
2050001,221.578,267.639,1150,13140,0.998279,0,2,179089,177939,1150
2057301,273.006,290.245,1182,18980,0.995367,0,2,180693,179511,1182
2058761,216.559,108.272,2428,8760,0.987158,0,2,182113,179685,2428
2080661,220.798,188.838,1704,11680,0.978987,0,2,184969,183265,1704
2080661,232.198,165.234,2016,11680,0.970363,0,2,185281,183265,2016
2102561,189.123,240.455,1732,16060,0.996448,0,2,189925,188193,1732
2102561,184.803,94.4257,2968,7300,0.992355,0,2,191161,188193,2968
2102561,187.202,82.6225,3172,8760,0.975811,0,2,191365,188193,3172
2102561,187.802,72.2947,3364,10220,0.973834,0,2,191557,188193,3364
2102561,161.048,24.8411,4412,17520,0.982259,0,2,192605,188193,4412
2102561,167.944,11.1486,5488,1460,0.990788,0,2,193681,188193,5488
2102561,169.451,9.755,5668,5840,0.98569,0,2,193861,188193,5668
2102561,169.395,8.53562,5837,7300,0.984978,0,2,194030,188193,5837
2153841,202.221,690.469,805,7480,0.979356,0,2,194462,193657,805
2153841,185.943,604.16,877,8940,0.976937,0,2,194534,193657,877
2153841,177.825,528.64,998,8940,0.977319,0,2,194655,193657,998
2156761,266.65,265.76,2376,14600,0.977207,0,2,197737,195361,2376
2156761,262.069,232.54,2606,16060,0.966306,0,2,197967,195361,2606
2197641,172.408,325.94,1128,16060,0.995449,0,2,202359,201231,1128
2216621,156.273,242.409,1314,18980,0.99839,0,2,205431,204117,1314
2216621,174.58,83.2939,2766,29200,0.988197,0,2,206883,204117,2766
2216621,182.757,72.8822,3006,30660,0.973422,0,2,207123,204117,3006
2216621,188.413,63.7719,3234,32120,0.960494,0,2,207351,204117,3234
2216621,178.361,55.8004,3342,33580,0.961683,0,2,207459,204117,3342
2216621,157.566,48.8254,3354,35040,0.960222,0,2,207471,204117,3354
2231221,130.574,325.804,810,37960,0.963295,0,2,207555,206745,810
2232681,121.752,292.953,807,39420,0.959133,0,2,207615,206808,807
2235601,112.533,264.209,792,40880,0.952992,0,2,207663,206871,792
2237061,104.466,239.058,777,42340,0.955118,0,2,207711,206934,777
2242901,103.408,217.051,810,43800,0.959478,0,2,207807,206997,810
2258961,92.4844,180.945,792,46720,0.960225,0,2,207915,207123,792
2260421,91.4238,166.202,813,48180,0.963947,0,2,207999,207186,813
2286701,167.108,41.5206,2544,18980,0.991741,0,2,210675,208131,2544
2286701,180.719,36.3305,2820,1460,0.991523,0,2,210951,208131,2820
2299841,173.194,250.617,1320,14600,0.994587,0,2,212271,210951,1320
2302761,216.154,238.048,1596,14600,0.991546,0,2,215163,213567,1596
2302761,219.135,208.292,1836,16060,0.990103,0,2,215403,213567,1836
2302761,239.461,36.7094,4824,16060,0.995756,0,2,218391,213567,4824
2312981,229.924,709.666,870,16192,0.985833,0,2,219999,219129,870
2312981,229.684,620.957,1098,17652,0.986354,0,2,220227,219129,1098
2369921,213.422,340.274,1386,11680,0.987595,0,2,222927,221541,1386
2369921,212.245,297.739,1590,11680,0.965396,0,2,223131,221541,1590
2372841,230.714,365.522,1110,11680,0.963471,0,2,223491,222381,1110
2374301,243.375,372.332,1022,14600,0.946787,0,2,223823,222801,1022
2375761,238.453,352.04,1016,16060,0.934689,0,2,224027,223011,1016
2378681,230.146,334.285,978,17520,0.931603,0,2,224199,223221,978
2380141,253.378,345,974,20440,0.936402,0,2,224615,223641,974
2383061,240.206,328.125,912,21900,0.943102,0,2,224763,223851,912
2426861,206.756,90.839,3235,5840,0.994918,0,2,236259,233024,3235
2426861,210.911,79.4841,3475,19019,0.973053,0,2,236499,233024,3475
2426861,213.048,69.5486,3703,19019,0.952672,0,2,236727,233024,3703
2426861,232.917,60.855,4075,19019,0.919838,0,2,237099,233024,4075
2426861,221.802,53.2482,4219,19019,0.891108,0,2,237243,233024,4219
2426861,213.577,46.5921,4375,19019,0.860969,0,2,237399,233024,4375
2426861,207.88,40.7681,4543,20479,0.834598,0,2,237567,233024,4543
2426861,204.395,35.6721,4723,21939,0.816523,0,2,237747,233024,4723
2426861,204.345,31.2131,4927,21939,0.803208,0,2,237951,233024,4927
2426861,207.302,27.3115,5155,21939,0.781557,0,2,238179,233024,5155
2426861,203.889,23.8975,5335,1460,0.770112,0,2,238359,233024,5335
2426861,194.903,20.9103,5467,5840,0.762598,0,2,238491,233024,5467
2426861,196.04,18.2965,5671,7300,0.761024,0,2,238695,233024,5671
2447301,188.035,663.759,621,8760,0.772146,0,2,238827,238206,621
2473581,196.031,607.79,657,10220,0.786877,0,2,239079,238422,657
2473581,197.027,531.816,861,11680,0.799768,0,2,239283,238422,861
2508621,272.628,318.942,1148,18776,0.983216,0,2,245243,244095,1148
2531981,260.173,306.251,1132,16060,0.985983,0,2,249635,248503,1132
2533441,256.152,296.845,1129,17520,0.985235,0,2,249863,248734,1129
2534901,254.133,289.239,1133,17556,0.973331,0,2,250103,248970,1133
2536361,250.866,282.584,1125,5840,0.972914,0,2,250331,249206,1125
2537821,249.508,276.761,1129,5840,0.96505,0,2,250571,249442,1129
2539281,245.319,271.666,1109,5840,0.953169,0,2,250787,249678,1109
2540741,243.154,267.208,1101,5840,0.935273,0,2,251015,249914,1101
2542201,254.76,285.932,1020,5840,0.912114,0,2,251351,250331,1020
2545121,247.415,280.19,976,18608,0.889349,0,2,251547,250571,976
2546581,266.988,304.167,908,18410,0.869431,0,2,251951,251043,908
2548041,269.615,304.646,888,18137,0.849502,0,2,252239,251351,888
2549501,267.413,296.065,904,17865,0.847064,0,2,252491,251587,904
2550961,260.986,288.557,884,19325,0.847431,0,2,252707,251823,884
2552421,259.863,281.987,900,20352,0.865252,0,2,252959,252059,900
2580161,222.266,282.694,954,10220,0.981924,0,2,257283,256329,954
2580161,224.483,247.357,1194,11680,0.976684,0,2,257523,256329,1194
2588921,237.221,132.75,2235,5840,0.989633,0,2,260307,258072,2235
2588921,237.569,116.156,2475,7300,0.970929,0,2,260547,258072,2475
2588921,237.872,101.637,2715,1460,0.973313,0,2,260787,258072,2715
2610821,257.635,321.238,1156,16060,0.980479,0,2,263429,262273,1156
2612281,252.43,302.583,1200,17520,0.962919,0,2,263645,262445,1200
2612281,222.877,264.76,1216,18980,0.953804,0,2,263661,262445,1216
2612281,224.265,202.707,1672,5840,0.955881,0,2,264117,262445,1672
2612281,219.107,177.369,1855,5840,0.942646,0,2,264300,262445,1855
2612281,212.718,155.198,2023,5840,0.923566,0,2,264468,262445,2023
2612281,211.629,135.798,2227,5840,0.90187,0,2,264672,262445,2227
2615201,215.175,327.823,795,5840,0.887886,0,2,264912,264117,795
2623961,206.278,313.845,723,20440,0.87065,0,2,265056,264333,723
2625421,229.493,301.615,899,20648,0.860569,0,2,265448,264549,899
2626881,226.307,290.913,887,20281,0.859248,0,2,265652,264765,887
2628341,225.018,280.299,897,19941,0.865592,0,2,265868,264971,897
2629801,223.891,271.011,907,19658,0.878643,0,2,266084,265177,907
2631261,222.905,262.885,917,19432,0.892563,0,2,266300,265383,917
2641481,219.792,102.477,2351,8760,0.973565,0,2,269176,266825,2351
2659001,206.371,247.279,1566,11680,0.989552,0,2,270976,269410,1566
2659001,248.879,56.9215,4422,13140,0.995095,0,2,273832,269410,4422
2659001,252.488,25.5461,5970,8760,0.991549,0,2,275380,269410,5970
2659001,241.269,7.68063,8094,5840,0.987459,0,2,277504,269410,8094
2698421,387.51,505.6,2178,7300,0.983729,0,2,283108,280930,2178
2698421,369.071,442.4,2418,8760,0.978263,0,2,283348,280930,2418
2714481,269.967,385.142,1086,11680,0.990214,0,2,284776,283690,1086
2733461,236.928,195.151,1848,10220,0.997739,0,2,288844,286996,1848
2739301,237.312,314.132,941,10220,0.980522,0,2,289084,288143,941
2753901,261.174,269.297,1106,5840,0.967376,0,2,291900,290794,1106
2755361,255.527,265.76,1081,5840,0.948954,0,2,292116,291035,1081
2758281,248.086,262.665,1036,5840,0.946585,0,2,292312,291276,1036
2759741,285.576,307.832,960,5840,0.944511,0,2,292860,291900,960
2777261,256.497,254.461,1080,17282,0.981324,0,2,295872,294792,1080
2815221,225.912,283.547,1024,10220,0.991992,0,2,301948,300924,1024
2823981,249.485,268.746,1124,18980,0.993906,0,2,303600,302476,1124
2825441,246.8,259.403,1158,20355,0.990918,0,2,303828,302670,1158
2825441,220.95,226.978,1198,20355,0.989553,0,2,303868,302670,1198
2825441,218.505,116.419,2273,5840,0.982142,0,2,304943,302670,2273
2835661,221.192,302.616,907,1460,0.968124,0,2,305183,304276,907
2837121,241.043,293.289,1059,21600,0.965859,0,2,305563,304504,1059
2840041,233.287,283.003,1027,21600,0.968876,0,2,305742,304715,1027
2840041,220.877,247.628,1161,21600,0.961517,0,2,305876,304715,1161
2840041,220.267,216.674,1377,21600,0.957577,0,2,306092,304715,1377
2840041,218.234,189.59,1581,21600,0.95913,0,2,306296,304715,1581
2840041,213.454,165.891,1761,21600,0.959239,0,2,306476,304715,1761
2859021,200.477,30.2998,4015,11680,0.992642,0,2,312221,308206,4015
2859021,216.604,0.823487,9955,5840,0.9923,0,2,318161,308206,9955
2975821,272.532,332.71,1131,17520,0.994986,0,2,332221,331090,1131
2977281,268.465,319.621,1143,18980,0.980612,0,2,332461,331318,1143
2978741,263.407,308.168,1143,19453,0.965536,0,2,332689,331546,1143
2981661,256.481,298.147,1123,19453,0.943594,0,2,332897,331774,1123
2984581,272.421,317.879,1051,19453,0.924395,0,2,333281,332230,1051
2987501,278.869,335.144,919,19351,0.912595,0,2,333605,332686,919
2988961,299.01,350.251,903,19030,0.884771,0,2,334045,333142,903
2990421,290.134,334.97,903,18723,0.865425,0,2,334273,333370,903
2993341,279.867,321.598,883,18454,0.855996,0,2,334481,333598,883
2994801,298.384,338.399,855,18185,0.852747,0,2,334909,334054,855
2996261,292.586,324.599,879,19645,0.854903,0,2,335161,334282,879
2997721,287.512,312.524,903,20618,0.869291,0,2,335413,334510,903
3009401,227.217,103.98,2371,8760,0.971093,0,2,338429,336058,2371
3051741,221.24,169.117,2480,8760,0.994539,0,2,345881,343401,2480
3051741,210.206,99.1333,3272,21961,0.990549,0,2,346673,343401,3272
3051741,203.431,86.7416,3428,21961,0.98048,0,2,346829,343401,3428
3051741,196.002,75.8989,3572,21961,0.95417,0,2,346973,343401,3572
3072181,200.001,407.662,1070,21961,0.906149,0,2,347201,346131,1070
3072181,196.001,356.704,1238,23421,0.854131,0,2,347369,346131,1238
3072181,186.501,312.116,1358,23421,0.806114,0,2,347489,346131,1358
3072181,181.188,273.101,1502,23421,0.7541,0,2,347633,346131,1502
3075101,184.04,356.464,766,23421,0.701087,0,2,347837,347071,766
3078021,188.035,354.156,644,25637,0.647201,0,1,348053,347409,644
3080941,194.531,347.386,584,24663,0.600051,0,1,348293,347709,584
3083861,204.714,341.463,560,23670,0.558795,0,1,348569,348009,560
3086781,215.125,336.28,548,22736,0.525196,0,1,348857,348309,548
3089701,224.234,331.745,536,21880,0.498296,0,2,349145,348609,536
3092621,238.205,327.777,572,21101,0.494759,0,2,349481,348909,572
3095541,251.929,324.305,620,20517,0.499164,0,2,349829,349209,620
3098461,262.438,321.267,656,20128,0.515519,0,2,350165,349509,656
3101381,276.133,318.608,728,19875,0.534829,0,2,350537,349809,728
3104301,282.117,316.282,752,19816,0.574225,0,2,350861,350109,752
3115981,246.435,118.128,2378,10220,0.911742,0,2,353837,351459,2378
3132041,277.772,361.451,1071,8760,0.95914,0,2,355661,354590,1071
3132041,237.805,124.198,2799,1460,0.98096,0,2,357389,354590,2799
3151021,244.003,327.413,1169,13140,0.985205,0,2,358913,357744,1169
3165621,225.452,328.822,902,15223,0.972844,0,2,361505,360603,902
3165621,227.271,287.72,1142,16683,0.931239,0,2,361745,360603,1142
3165621,225.862,251.755,1358,16683,0.893584,0,2,361961,360603,1358
3167081,243.629,313.66,979,16683,0.838136,0,2,362329,361350,979
3170001,231.676,305.578,878,16910,0.789619,0,2,362477,361599,878
3172921,240.216,321.381,746,16910,0.744667,0,2,362777,362031,746
3175841,253.689,335.208,662,16802,0.705333,0,2,363125,362463,662
3177301,278.478,347.307,682,16451,0.680917,0,2,363577,362895,682
3178761,270.668,330.894,682,16167,0.667052,0,2,363793,363111,682
3180221,266.835,316.532,706,15923,0.662421,0,2,364033,363327,706
3181681,260.48,303.965,706,15748,0.653368,0,2,364249,363543,706
3183141,259.42,292.97,742,15599,0.650447,0,2,364501,363759,742
3184601,258.493,283.349,778,15531,0.647891,0,2,364753,363975,778
3186061,256.181,274.93,802,15531,0.645655,0,2,364993,364191,802
3187521,249.659,267.564,790,16991,0.651198,0,2,365197,364407,790
3190441,248.951,261.118,818,18451,0.663548,0,2,365441,364623,818
3191901,272.832,282.478,826,18451,0.679355,0,2,365881,365055,826
3194821,261.728,268.669,838,18451,0.698185,0,2,366065,365227,838
3197741,275.512,278.085,866,18534,0.722162,0,2,366437,365571,866
3199201,287.073,286.324,890,18534,0.748142,0,2,366805,365915,890
3202121,274.189,272.034,902,18534,0.773374,0,2,366989,366087,902
3212341,246.047,119.396,2354,8760,0.939083,0,2,369809,367455,2354
3212341,243.791,104.471,2582,10220,0.941697,0,2,370037,367455,2582
3224021,246.881,390.058,1011,11680,0.970084,0,2,371573,370562,1011
3224021,244.918,175.056,2463,15614,0.981574,0,2,373025,370562,2463
3240081,251.646,428.038,1053,8760,0.989299,0,2,374321,373268,1053
3254681,322.653,490.578,887,17074,0.988823,0,2,376903,376016,887
3257601,355.072,479.88,1064,17857,0.95147,0,2,377485,376421,1064
3260521,352.688,473.895,968,17857,0.921286,0,2,377821,376853,968
3263441,349.102,468.658,860,17857,0.882376,0,2,378145,377285,860
3266361,354.964,464.076,824,14814,0.844579,0,2,378541,377717,824
3267821,361.093,460.067,796,17734,0.822756,0,2,378945,378149,796
3269281,352.582,437.433,810,17973,0.808662,0,2,379238,378428,810
3270741,340.009,417.629,783,17818,0.793829,0,2,379490,378707,783
3272201,329.008,391.8,824,17652,0.79585,0,2,379742,378918,824
3273661,316.382,369.2,841,17564,0.802619,0,2,379970,379129,841
3275121,302.334,349.425,834,17508,0.818542,0,2,380174,379340,834
3276581,297.542,332.122,887,17453,0.837474,0,2,380438,379551,887
3295561,208.654,88.154,2480,10220,0.980002,0,2,384698,382218,2480
3307241,218.754,129.314,2364,16060,0.987147,0,2,386270,383906,2364
3333521,219.679,129.959,2306,5840,0.983838,0,2,390458,388152,2306
3343741,221.594,317.964,907,5840,0.964608,0,2,390693,389786,907
3343741,223.895,278.219,1147,5840,0.957782,0,2,390933,389786,1147
3343741,239.408,243.441,1495,5840,0.92181,0,2,391281,389786,1495
3343741,236.482,213.011,1711,19886,0.882833,0,2,391497,389786,1711
3343741,233.922,186.385,1927,19886,0.838729,0,2,391713,389786,1927
3343741,230.182,163.087,2131,21346,0.785138,0,2,391917,389786,2131
3343741,217.909,142.701,2263,21762,0.745746,0,2,392049,389786,2263
3353961,207.17,359.238,520,1460,0.698778,0,2,392181,391661,520
3356881,226.274,338.083,690,5840,0.65018,0,2,392541,391851,690
3356881,203.99,295.823,738,8760,0.610158,0,2,392589,391851,738
3356881,200.991,258.845,918,8760,0.575138,0,2,392769,391851,918
3356881,192.367,226.49,1050,8760,0.541996,0,2,392901,391851,1050
3358341,212.821,302.428,572,8760,0.515496,0,2,393257,392685,572
3359801,214.719,288.375,610,10220,0.494809,0,2,393485,392875,610
3362721,212.379,276.078,616,11680,0.486708,0,2,393681,393065,616
3364181,237.831,289.068,652,14600,0.48212,0,2,394097,393445,652
3365641,238.102,279.56,679,16060,0.480605,0,2,394337,393658,679
3367101,238.34,271.24,706,16895,0.486779,0,2,394577,393871,706
3368561,235.547,263.96,709,16621,0.492182,0,2,394793,394084,709
3370021,234.604,257.59,724,16388,0.499409,0,2,395021,394297,724
3371481,235.278,252.016,751,16210,0.508233,0,2,395261,394510,751
3372941,234.369,247.139,766,16100,0.525954,0,2,395489,394723,766
3375861,231.072,242.872,761,17560,0.54396,0,2,395697,394936,761
3377321,258.688,265.763,787,18883,0.562215,0,2,396149,395362,787
3380241,253.852,259.167,794,18869,0.588188,0,2,396369,395575,794
3383161,270.121,269.271,838,18869,0.633414,0,2,396753,395915,838
3393381,245.049,114.843,2388,10220,0.904365,0,2,399573,397185,2388
3393381,242.918,100.487,2616,11680,0.90882,0,2,399801,397185,2616
3416741,241.101,160.178,2248,8760,0.984689,0,2,403365,401117,2248
3425501,233.44,221.531,1608,13140,0.984379,0,2,404733,403125,1608
3425501,234.26,193.839,1848,13140,0.977581,0,2,404973,403125,1848
3425501,252.385,113.625,2976,5840,0.981858,0,2,406101,403125,2976
3425501,249.337,99.422,3204,7300,0.956626,0,2,406329,403125,3204
3425501,246.67,86.9943,3432,8760,0.925798,0,2,406557,403125,3432
3425501,238.336,76.12,3612,5840,0.886323,0,2,406737,403125,3612
3425501,244.544,66.605,3900,5840,0.841783,0,2,407025,403125,3900
3425501,227.476,58.2794,4008,5840,0.80281,0,2,407133,403125,4008
3466381,258.401,146.06,2554,13140,0.981353,0,2,415641,413087,2554
3485361,245.788,322.017,1166,13140,0.986427,0,2,417321,416155,1166
3485361,241.089,126.455,2834,5840,0.99217,0,2,418989,416155,2834
3485361,231.698,56.7524,4166,10220,0.977736,0,2,420321,416155,4166
3485361,231.236,49.6583,4394,11680,0.939269,0,2,420549,416155,4394
3485361,229.331,43.451,4610,13140,0.90311,0,2,420765,416155,4610
3485361,241.165,38.0196,4934,14600,0.868972,0,2,421089,416155,4934
3485361,226.019,33.2672,5054,16060,0.8416,0,2,421209,416155,5054
3485361,215.767,29.1088,5198,17520,0.81765,0,2,421353,416155,5198
3485361,217.296,25.4702,5426,1460,0.789194,0,2,421581,416155,5426
3485361,217.134,22.2864,5642,5840,0.761795,0,2,421797,416155,5642
3485361,210.992,19.5006,5810,7300,0.74532,0,2,421965,416155,5810
3513101,201.118,681.063,630,5840,0.728405,0,2,422097,421467,630
3513101,202.978,595.93,846,5840,0.713605,0,2,422313,421467,846
3513101,197.106,521.439,1002,5840,0.698154,0,2,422469,421467,1002
3514561,216.968,528.384,781,5840,0.689635,0,2,422825,422044,781
3516021,215.347,488.086,779,20440,0.68468,0,2,423029,422250,779
3518941,212.928,451.075,783,20500,0.677845,0,2,423225,422442,783
3520401,238.312,442.691,815,20059,0.686865,0,2,423641,422826,815
3523321,231.523,411.355,807,19739,0.702257,0,2,423825,423018,807
3524781,254.583,407.935,839,19435,0.723225,0,2,424241,423402,839
3526241,251.26,380.943,875,19238,0.749071,0,2,424469,423594,875
3527701,248.353,357.325,911,19131,0.776688,0,2,424697,423786,911
3556901,236.221,196.907,1764,7300,0.98969,0,2,430293,428529,1764
3567121,236.93,201.923,1656,10220,0.992873,0,2,431709,430053,1656
3567121,237.314,176.682,1896,11680,0.992514,0,2,431949,430053,1896
3578801,225.022,111.807,2551,18980,0.983846,0,2,435069,432518,2551
3578801,226.894,97.8311,2791,19101,0.972115,0,2,435309,432518,2791
3578801,224.033,85.6023,2995,20561,0.959351,0,2,435513,432518,2995
3578801,217.029,74.902,3163,22021,0.940682,0,2,435681,432518,3163
3578801,207.9,65.5392,3307,23185,0.924346,0,2,435825,432518,3307
3593401,192.412,379.847,811,18149,0.907553,0,2,435909,435098,811
3596321,187.861,356.616,773,19609,0.887859,0,2,436065,435292,773
3602161,185.378,336.289,747,21069,0.883127,0,2,436233,435486,747
3602161,177.206,294.253,867,22529,0.863986,0,2,436353,435486,867
3602161,176.055,257.471,1035,22529,0.854738,0,2,436521,435486,1035
3605081,185.548,283.412,822,22529,0.859145,0,2,436773,435951,822
3608001,187.855,273.861,819,25449,0.865502,0,2,436977,436158,819
3613841,181.514,252.878,774,31289,0.893275,0,2,437301,436527,774
3628441,217.665,74.5055,2676,1460,0.974941,0,2,440061,437385,2676
3662021,202.283,85.4518,2912,5840,0.988154,0,2,445857,442945,2912
3662021,204.997,74.7703,3136,7300,0.985885,0,2,446081,442945,3136
3662021,180.873,65.424,3148,8300,0.982649,0,2,446093,442945,3148
3675161,173.928,348.532,890,12680,0.985876,0,2,446585,445695,890
3690761,639.575,783.23,443,18520,0.874006,0,1,451111,450668,443
3693681,607.003,731.326,454,19138,0.773505,0,1,451490,451036,454
3696601,576.127,685.91,446,18281,0.680567,0,1,451850,451404,446
3698061,551.611,646.171,458,17519,0.601746,0,1,452230,451772,458
3700981,504.16,588.4,446,16884,0.532778,0,1,452402,451956,446
3702441,493.14,560.85,494,16297,0.484931,0,1,452818,452324,494
3705361,454.498,513.744,494,15884,0.445564,0,1,453002,452508,494
3706821,445.185,495.526,506,18439,0.423619,0,1,453382,452876,506
3709741,412.537,456.585,506,18138,0.416916,0,2,453566,453060,506
3712661,399.97,436.262,524,17884,0.406052,0,2,453878,453354,524
3715581,396.474,418.479,602,17694,0.414045,0,2,454250,453648,602
3718501,391.915,402.919,668,17389,0.43354,0,2,454610,453942,668
3721421,381.925,389.304,686,17389,0.460597,0,2,454922,454236,686
3724341,377.685,377.891,736,17389,0.504273,0,2,455270,454534,736
3727261,376.974,368.405,806,17389,0.564988,0,2,455642,454836,806
3736021,257.311,128.453,2341,11680,0.891114,0,2,458234,455893,2341
3736021,255.147,112.397,2581,13140,0.885975,0,2,458474,455893,2581
3736021,251.754,98.347,2809,14600,0.890228,0,2,458702,455893,2809
3736021,250.284,86.0536,3049,14600,0.9002,0,2,458942,455893,3049
3736021,248.999,75.2969,3289,1460,0.911425,0,2,459182,455893,3289
3769601,222.712,89.8034,3168,14872,0.983106,0,2,464678,461510,3168
3769601,221.873,78.578,3384,16332,0.960218,0,2,464894,461510,3384
3769601,219.639,68.7558,3588,17792,0.93519,0,2,465098,461510,3588
3779821,223.684,439.661,804,19252,0.917042,0,2,465350,464546,804
3791501,218.223,407.454,802,19557,0.896161,0,2,465530,464728,802
3791501,207.445,356.522,934,19557,0.880391,0,2,465662,464728,934
3794421,220.515,357.457,882,19557,0.866592,0,2,465974,465092,882
3797341,234.95,358.275,854,18736,0.844518,0,2,466310,465456,854
3800261,253.582,358.99,874,18660,0.830203,0,2,466694,465820,874
3803181,263.884,360.866,836,18629,0.827678,0,2,467030,466194,836
3804641,281.398,363.758,856,18523,0.842968,0,2,467434,466578,856
3816321,236.576,64.5568,3500,8760,0.979555,0,2,471614,468114,3500
3816321,240.314,13.0029,6416,8760,0.994632,0,2,474530,468114,6416
3841141,229.565,144.618,3763,11680,0.996554,0,2,477530,473767,3763
3841141,244.571,84.7725,4819,5840,0.98548,0,2,478586,473767,4819
3870341,378.999,763.176,627,17520,0.941045,0,2,479906,479279,627
3873261,378.124,692.529,801,18980,0.897164,0,2,480278,479477,801
3876181,375.859,655.463,765,19008,0.861269,0,2,480638,479873,765
3879101,378.377,623.03,765,18669,0.83986,0,2,481034,480269,765
3880561,384.579,594.651,797,18374,0.831128,0,2,481462,480665,797
3882021,365.007,545.07,827,18183,0.828487,0,2,481690,480863,827
3883481,347.881,501.686,857,18065,0.826176,0,2,481918,481061,857
3884941,331.396,463.725,875,18020,0.836654,0,2,482134,481259,875
3886401,316.972,430.51,893,18020,0.850822,0,2,482350,481457,893
3899541,233.058,27.677,5055,16060,0.984116,0,2,488294,483239,5055
3899541,233.925,24.2174,5295,17520,0.983602,0,2,488534,483239,5295
3899541,241.071,2.50187,9495,5840,0.985806,0,2,492734,483239,9495
3899541,240.937,2.18913,9735,5840,0.96508,0,2,492974,483239,9735
3899541,239.32,1.91549,9963,5840,0.933195,0,2,493202,483239,9963
3959401,449.752,969.559,1088,19723,0.964485,0,2,497122,496034,1088
3960861,324.864,447.828,2178,8760,0.975311,0,2,498410,496232,2178
3960861,312.756,391.85,2406,10220,0.975897,0,2,498638,496232,2406
3982761,257.198,312.395,1169,16060,0.986395,0,2,501466,500297,1169
4007581,268.004,289.228,1151,17520,0.99127,0,2,505870,504719,1151
4009041,263.004,273.449,1216,18980,0.979861,0,2,506098,504882,1216
4009041,235.128,239.268,1256,5840,0.971129,0,2,506138,504882,1256
4009041,234.237,209.36,1484,5840,0.960988,0,2,506366,504882,1484
4009041,224.457,183.19,1640,5840,0.942114,0,2,506522,504882,1640
4009041,220.4,160.291,1832,5840,0.9206,0,2,506714,504882,1832
4009041,212.35,140.255,1988,4380,0.891775,0,2,506870,504882,1988
4011961,232.306,327.723,720,4380,0.849053,0,2,507242,506522,720
4019261,224.268,310.757,696,20001,0.821671,0,2,507410,506714,696
4020721,236.235,292.288,853,24711,0.795213,0,2,507730,506877,853
4022181,241.205,301.377,764,24192,0.777061,0,2,508006,507242,764
4025101,231.055,284.08,761,23529,0.771178,0,2,508166,507405,761
4028021,245.673,289.32,783,22938,0.776031,0,2,508514,507731,783
4029481,260.964,293.905,825,22472,0.802777,0,2,508882,508057,825
4041161,227.65,99.4413,2489,8760,0.961491,0,2,511850,509361,2489
4055761,219.953,284.877,1037,10220,0.978628,0,2,513362,512325,1037
4087881,227.717,234.831,1416,11680,0.989419,0,2,519135,517719,1416
4087881,230.596,179.792,1896,5840,0.989399,0,2,519615,517719,1896
4087881,230.271,157.318,2124,18980,0.989474,0,2,519843,517719,2124
4087881,220.987,137.653,2280,20440,0.98954,0,2,519999,517719,2280
4087881,209.864,120.447,2412,21900,0.977097,0,2,520131,517719,2412
4096641,242.131,357.391,864,23360,0.96871,0,2,520599,519735,864
4099561,225.365,331.842,819,24820,0.953871,0,2,520707,519888,819
4106861,212.194,305.612,817,26280,0.950888,0,2,520827,520010,817
4109781,209.67,282.66,887,24429,0.955777,0,2,521019,520132,887
4194461,189.546,22.9913,3850,11680,0.992498,0,2,536907,533057,3850
4194461,200.771,1.21826,8326,21900,0.998353,0,2,541383,533057,8326
4194461,205.674,1.06598,8566,23360,0.994808,0,2,541623,533057,8566
4194461,197.341,0.36628,10118,28286,0.984466,0,2,543175,533057,10118
4214901,312.593,1520.36,752,28286,0.98783,0,2,545971,545219,752
4217821,302.019,1346.32,852,29746,0.986851,0,2,546199,545347,852
4217821,193.144,528.692,1788,28971,0.993586,0,2,547135,545347,1788
4217821,174.314,404.78,2016,28971,0.98384,0,2,547363,545347,2016
4217821,179.524,354.183,2232,28971,0.97586,0,2,547579,545347,2232
4306881,192.961,158.417,2067,14600,0.990318,0,2,550615,548548,2067
4317101,210.701,87.6457,2760,8760,0.997444,0,2,553567,550807,2760
4317101,217.61,44.9543,3876,16060,0.996189,0,2,554683,550807,3876
4317101,220.408,39.335,4116,17520,0.990415,0,2,554923,550807,4116
4317101,209.584,15.4467,5556,7300,0.992486,0,2,556363,550807,5556
4390101,339.33,716.455,1034,20845,0.997195,0,2,564031,562997,1034
4447041,251.36,323.967,1167,16060,0.989992,0,2,574107,572940,1167
4447041,224.94,283.471,1207,17520,0.987493,0,2,574147,572940,1207
4447041,225.323,248.038,1435,18980,0.984056,0,2,574375,572940,1435
4466021,241.269,272.041,1138,22511,0.99383,0,2,577087,575949,1138
4467481,239.61,264.286,1156,22511,0.982101,0,2,577315,576159,1156
4468941,234.159,257.5,1142,22511,0.981839,0,2,577511,576369,1142
4492301,249.124,265.106,1184,23510,0.995624,0,2,581263,580079,1184
4528801,201.835,115.038,2433,10220,0.997459,0,2,588515,586082,2433
4528801,206.605,100.658,2673,10220,0.986527,0,2,588755,586082,2673
4533181,225.266,370.941,1190,11680,0.978953,0,2,590231,589041,1190
4533181,227.108,324.573,1430,13140,0.974084,0,2,590471,589041,1430
4533181,198.809,43.7959,4166,13140,0.984003,0,2,593207,589041,4166
4533181,214.458,38.3214,4490,14600,0.984753,0,2,593531,589041,4490
4591581,238.411,104.798,3626,11680,0.990933,0,2,601127,597501,3626
4591581,236.251,41.1538,5258,16930,0.990189,0,2,602759,597501,5258
4633921,291.953,492.845,1181,16060,0.9958,0,2,605467,604286,1181
4635381,285.459,465.364,1148,16674,0.983825,0,2,605707,604559,1148
4647061,267.701,339.098,1010,17867,0.990692,0,2,607753,606743,1010
4648521,267.238,330.836,1001,19188,0.985606,0,2,608017,607016,1001
4649981,263.833,323.606,968,19103,0.981155,0,2,608257,607289,968
4651441,269.854,317.281,1007,18985,0.982261,0,2,608569,607562,1007
4654361,263.622,304.87,1009,18932,0.980728,0,2,608789,607780,1009
4676261,270.282,274.031,1079,22346,0.992853,0,2,612193,611114,1079
4708381,210.554,302.376,1157,13140,0.997005,0,2,616565,615408,1157
4708381,214.234,264.579,1397,13140,0.99488,0,2,616805,615408,1397
4708381,230.446,118.742,2861,7300,0.992702,0,2,618269,615408,2861
4722981,248.621,307.607,1157,13140,0.991725,0,2,619837,618680,1157
4733201,233.743,343.296,768,17520,0.99175,0,2,621341,620573,768
4756561,274.262,267.891,1264,23537,0.994978,0,2,625189,623925,1264
4756561,241.98,234.404,1280,24997,0.989356,0,2,625205,623925,1280
4779921,199.22,143.632,2056,11680,0.998186,0,2,629527,627471,2056
4813501,199.504,176.241,2236,11680,0.993686,0,2,635467,633231,2236
4813501,203.066,154.211,2464,11680,0.980725,0,2,635695,633231,2464
4813501,204.683,134.934,2680,1460,0.979384,0,2,635911,633231,2680
4839781,231.515,4.51936,8116,5840,0.993651,0,2,644851,636735,8116
4890881,365.359,527.584,2241,7300,0.993091,0,2,649615,647374,2241
4890881,348.189,461.636,2469,1460,0.991455,0,2,649843,647374,2469
4905481,260.492,374.162,1151,11680,0.995394,0,2,651259,650108,1151
4914241,260.352,315.599,1092,18980,0.991683,0,2,652880,651788,1092
4927381,212.004,110.253,2333,10220,0.994967,0,2,655945,653612,2333
4946361,204.344,269.297,949,11680,0.985524,0,2,657373,656424,949
4946361,205.801,235.635,1165,13140,0.979833,0,2,657589,656424,1165
4955121,215.682,112.83,2275,8760,0.994108,0,2,660157,657882,2275
4974101,206.784,344.573,972,11680,0.995186,0,2,661573,660601,972
4974101,209.436,301.502,1200,13140,0.993288,0,2,661801,660601,1200
4991621,241.984,287.346,1228,13140,0.995067,0,2,664797,663569,1228
4991621,221.302,112.84,2612,8760,0.993063,0,2,666181,663569,2612
5020821,231.493,237.933,1230,5840,0.98643,0,2,669285,668055,1230
5020821,207.556,208.191,1270,5840,0.973126,0,2,669325,668055,1270
5033961,229.095,124.265,2280,7300,0.987224,0,2,673657,671377,2280
5073381,187.489,3.97522,7416,21900,0.984995,0,2,685357,677941,7416
5073381,194.053,3.47832,7656,23360,0.971871,0,2,685597,677941,7656
5073381,199.797,3.04353,7896,24820,0.962887,0,2,685837,677941,7896
5073381,200.322,2.66309,8100,26280,0.961276,0,2,686041,677941,8100
5073381,194.782,2.3302,8256,27740,0.962367,0,2,686197,677941,8256
5165361,187.234,243.877,2520,27126,0.995791,0,2,692545,690025,2520
5172661,191.829,425.451,876,11680,0.995611,0,2,693745,692869,876
5182881,196.726,401.27,875,13140,0.98991,0,2,693976,693101,875
5185801,200.635,372.861,929,14600,0.989921,0,2,694204,693275,929
5185801,204.106,167.338,2165,23360,0.994227,0,2,695440,693275,2165
5185801,207.093,146.421,2393,24206,0.992448,0,2,695668,693275,2393
5210001,453.141,355.269,2445,8760,0.997585,0,2,704974,702529,2445
5227521,331.526,443.31,997,11680,0.990166,0,2,706414,705417,997
5234821,350.883,402.612,1139,18980,0.987986,0,2,707886,706747,1139
5236281,219.909,128.007,2385,10220,0.990138,0,2,709294,706909,2385
5252341,197.919,234.802,1208,14600,0.987035,0,2,711010,709802,1208
5259641,225.324,375.18,736,7300,0.976795,0,2,712894,712158,736
5269861,216.659,349.783,720,8760,0.958446,0,2,713050,712330,720
5272781,224.076,322.06,868,10220,0.92489,0,2,713326,712458,868
5275701,227.567,297.802,992,11680,0.883029,0,2,713578,712586,992
5278621,221.621,299.077,864,14600,0.8489,0,2,713758,712894,864
5281541,216.418,293.692,788,17520,0.826538,0,2,713938,713150,788
5284461,213.366,288.981,724,20440,0.79947,0,2,714130,713406,724
5287381,221.195,284.858,744,23360,0.780787,0,2,714406,713662,744
5290301,220.546,281.251,704,26280,0.774438,0,2,714622,713918,704
5293221,227.478,278.095,724,26940,0.786384,0,2,714898,714174,724
5296141,233.543,275.333,744,26325,0.804336,0,2,715174,714430,744
5320961,236.33,181.705,1680,14600,0.978563,0,2,719530,717850,1680
5351621,209.484,361.331,1016,5840,0.982201,0,2,726406,725390,1016
5366221,213.299,336.164,1096,5840,0.940676,0,2,726646,725550,1096
5369141,216.636,345.644,924,5840,0.899342,0,2,726886,725962,924
5370601,212.057,329.438,888,22692,0.865674,0,2,727066,726178,888
5376441,200.55,316.758,780,22692,0.833715,0,2,727186,726406,780
5379361,214.481,307.164,852,22692,0.80825,0,2,727498,726646,852
5382281,226.671,318.768,764,22455,0.793469,0,2,727810,727046,764
5385201,238.837,318.922,768,22036,0.795535,0,2,728134,727366,768
5386661,253.482,319.057,804,24610,0.814843,0,2,728490,727686,804
5399801,228.876,130.579,2140,13140,0.953629,0,2,731074,728934,2140
5399801,230.267,114.256,2380,10220,0.948175,0,2,731314,728934,2380
5426081,247.032,17.4317,6306,5840,0.990618,0,2,739606,733300,6306
5426081,246.153,15.2527,6546,18718,0.950541,0,2,739846,733300,6546
5426081,245.384,13.3461,6786,20178,0.916723,0,2,740086,733300,6786
5434841,264.211,805.428,832,21638,0.878383,0,2,740482,739650,832
5459661,247.685,732.249,744,21840,0.834835,0,2,740614,739870,744
5459661,230.224,640.718,852,21840,0.796731,0,2,740722,739870,852
5462581,229.946,604.628,728,21840,0.758389,0,2,740950,740222,728
5465501,243.203,573.05,712,21310,0.714841,0,2,741286,740574,712
5468421,248.802,545.419,648,22131,0.679235,0,2,741574,740926,648
5471341,262.702,521.241,656,21536,0.645581,0,2,741934,741278,656
5474261,271.864,498.086,656,21027,0.631133,0,2,742270,741614,656
5477181,279.881,475.825,672,20592,0.630992,0,2,742606,741934,672
5478641,292.396,456.347,732,20228,0.648368,0,2,742986,742254,732
5481561,280.347,419.304,768,20025,0.676072,0,2,743182,742414,768
5490321,281.187,318.121,1120,19909,0.827604,0,2,744654,743534,1120
5491781,226.611,117.163,2497,13140,0.927013,0,2,746191,743694,2497
5506381,224.022,182.496,2253,16989,0.984637,0,2,749200,746947,2253
5506381,220.02,159.684,2445,16989,0.985307,0,2,749392,746947,2445
5529741,194.145,356.16,1040,11680,0.98423,0,2,750670,749630,1040
5529741,195.377,311.64,1244,11680,0.959951,0,2,750874,749630,1244
5529741,194.954,272.685,1436,11680,0.927458,0,2,751066,749630,1436
5530721,227.585,339.225,1087,11680,0.855275,0,2,751522,750435,1087
5532181,437.137,616.446,434,12660,0.769616,0,1,753426,752992,434
5533641,408.245,564.641,438,14120,0.694664,0,1,753632,753194,438
5535101,390.214,519.311,500,5840,0.639081,0,1,753896,753396,500
5538021,367.438,479.647,506,5840,0.602946,0,2,754104,753598,506
5539481,381.008,465.066,619,15600,0.601328,0,2,754580,753961,619
5540941,363.382,432.183,657,15350,0.627412,0,2,754820,754163,657
5542401,352.459,404.41,723,15197,0.662735,0,2,755096,754373,723
5552621,264.563,167.85,1969,8760,0.914865,0,2,757812,755843,1969
5589121,244.902,217.945,1636,17464,0.993606,0,2,764004,762368,1636
5599341,215.172,178.642,1590,5840,0.966239,0,2,765384,763794,1590
5599341,218.276,156.312,1830,5840,0.924209,0,2,765624,763794,1830
5608101,219.491,297.398,773,5840,0.884933,0,2,765852,765079,773
5608101,234.055,260.223,1109,5840,0.835566,0,2,766188,765079,1109
5608101,221.298,227.695,1241,18924,0.787371,0,2,766320,765079,1241
5608101,210.136,199.234,1373,19832,0.742699,0,2,766452,765079,1373
5608101,216.869,174.329,1637,4380,0.691112,0,2,766716,765079,1637
5616861,207.76,313.413,494,5840,0.645973,0,2,766860,766366,494
5618321,217.29,284.987,692,19832,0.598976,0,1,767144,766452,692
5621241,213.129,282.363,612,19479,0.550354,0,1,767328,766716,612
5624161,223.988,291.568,556,20138,0.50781,0,1,767628,767072,556
5627081,236.489,299.622,524,19886,0.465584,0,1,767952,767428,524
5630001,245.928,302.919,510,19359,0.431136,0,1,768264,767754,510
5632921,254.187,304.804,504,18876,0.400994,0,1,768576,768072,504
5634381,263.914,306.454,518,18437,0.37962,0,1,768908,768390,518
5637301,252.425,288.022,531,18071,0.368417,0,1,769080,768549,531
5638761,263.871,291.769,557,17778,0.371115,0,2,769424,768867,557
5641681,255.388,275.173,594,17573,0.378476,0,2,769620,769026,594
5644601,268.464,280.526,636,17456,0.397416,0,2,769980,769344,636
5647521,279.906,285.211,678,17442,0.431489,0,2,770340,769662,678
5650441,291.418,289.309,732,17442,0.478803,0,2,770712,769980,732
5653361,305.991,292.896,822,17442,0.540203,0,2,771120,770298,822
5663581,269.99,119.098,2610,13140,0.890409,0,2,774180,771570,2610
5684021,242.216,166.945,2354,7300,0.974436,0,2,777228,774874,2354
5684021,241.939,146.077,2594,7300,0.965131,0,2,777468,774874,2594
5708841,254.893,298.614,1208,5840,0.978224,0,2,780284,779076,1208
5710301,253.031,280.287,1296,5840,0.952196,0,2,780524,779228,1296
5710301,226.402,245.251,1336,5840,0.928171,0,2,780564,779228,1336
5710301,228.102,214.595,1576,5840,0.9059,0,2,780804,779228,1576
5713221,493.589,607.77,568,1460,0.873912,0,2,783156,782588,568
5714681,509.89,602.799,624,18980,0.865923,0,2,783780,783156,624
5716141,471.654,546.949,672,20440,0.873933,0,2,783984,783312,672
5719061,436.697,498.08,708,21900,0.885941,0,2,784176,783468,708
5730741,288.742,172.278,2280,8760,0.961245,0,2,786996,784716,2280
5730741,282.65,150.743,2520,8760,0.949839,0,2,787236,784716,2520
5758481,215.224,108.247,2620,13140,0.987778,0,2,791784,789164,2620
5776001,357.188,484.613,859,24820,0.975937,0,2,795432,794573,859
5778921,326.039,437.536,859,26280,0.965195,0,2,795540,794681,859
5787681,297.285,396.344,847,27740,0.943295,0,2,795636,794789,847
5790601,279.624,360.301,895,29200,0.926633,0,2,795792,794897,895
5793521,270.171,342.263,883,32120,0.912054,0,2,795996,795113,883
5796441,257.4,326.481,835,33552,0.884297,0,2,796164,795329,835
5799361,249.225,312.67,811,32876,0.85751,0,2,796356,795545,811
5802281,240.572,300.587,775,32200,0.836572,0,2,796536,795761,775
5805201,240.5,290.013,799,31497,0.82075,0,2,796776,795977,799
5808121,231.438,280.762,751,30956,0.809406,0,2,796944,796193,751
5811041,231.008,272.666,763,30334,0.80948,0,2,797172,796409,763
5813961,232.132,265.583,787,29820,0.807045,0,2,797412,796625,787
5816881,228.615,259.385,775,29469,0.804915,0,2,797616,796841,775
5819801,231.538,253.962,811,29118,0.82055,0,2,797868,797057,811
5822721,229.596,249.217,811,29630,0.841732,0,2,798084,797273,811
5844621,233.359,231.312,1570,11680,0.983732,0,2,802488,800918,1570
5844621,262.659,118.642,3034,7300,0.985406,0,2,803952,800918,3034
5844621,219.297,7.18469,7522,18980,0.994116,0,2,808440,800918,7522
5844621,221.885,6.2866,7762,5840,0.993602,0,2,808680,800918,7762
5844621,246.649,5.50078,8182,5840,0.978152,0,2,809100,800918,8182
5844621,242.818,4.81318,8398,5840,0.947133,0,2,809316,800918,8398
5854841,599.466,1367.84,585,21900,0.932491,0,2,812412,811827,585
5895721,550.033,1216.86,629,21881,0.92218,0,2,812616,811987,629
5905941,295.686,291.549,2389,10220,0.970576,0,2,815496,813107,2389
5905941,288.726,255.105,2629,10220,0.960504,0,2,815736,813107,2629
5942441,209.162,300.139,1233,14600,0.989767,0,2,819997,818764,1233
5943901,172.281,43.5326,3580,10220,0.997542,0,2,822824,819244,3580
5943901,177.746,38.091,3796,11680,0.975349,0,2,823040,819244,3796
5943901,181.028,33.3296,4000,13140,0.93843,0,2,823244,819244,4000
5943901,181.024,29.1634,4181,14600,0.897377,0,2,823425,819244,4181
5943901,179.396,25.518,4349,5840,0.838955,0,2,823593,819244,4349
5943901,166.472,22.3282,4425,5840,0.782835,0,2,823669,819244,4425
5943901,160.663,19.5372,4545,5840,0.716231,0,1,823789,819244,4545
5943901,155.58,17.0951,4665,5840,0.642952,0,1,823909,819244,4665
5943901,146.633,14.9582,4749,5840,0.566333,0,1,823993,819244,4749
5974561,325.303,774.213,236,18980,0.495541,0,1,825569,825333,236
5974801,323.266,692.187,427,20440,0.434849,0,1,825878,825451,427
5977721,442.232,774.413,352,20680,0.387993,0,1,827153,826801,352
5980641,420.828,707.112,387,23600,0.348244,0,1,827424,827037,387
5983561,393.35,648.223,352,25240,0.315963,0,1,827625,827273,352
5986481,380.181,596.695,404,23854,0.307718,0,1,827913,827509,404
5989401,371.658,551.608,480,22815,0.328003,0,2,828225,827745,480
5992321,362.701,512.157,544,22147,0.370753,0,2,828525,827981,544
5995241,360.863,477.637,656,21751,0.438159,0,2,828873,828217,656
6005461,265.919,146.602,2508,10220,0.864419,0,2,831621,829113,2508
6030281,227.666,108.247,3239,1460,0.975929,0,2,838917,835678,3239
6030281,278.707,94.7164,3875,5840,0.920188,0,2,839553,835678,3875
6056561,255.869,465.377,911,7300,0.873914,0,2,839649,838738,911
6056561,238.885,407.205,1031,8760,0.828425,0,2,839769,838738,1031
6059481,222.525,411.304,699,8760,0.786122,0,2,839877,839178,699
6060941,231.709,387.391,775,10220,0.736607,0,2,840173,839398,775
6063861,228.745,366.467,763,11680,0.690781,0,2,840381,839618,763
6066781,240.652,375.659,647,14600,0.648183,0,2,840705,840058,647
6068241,267.071,383.701,659,15674,0.61591,0,2,841157,840498,659
6069701,259.187,363.239,643,15435,0.590172,0,2,841361,840718,643
6071161,255.289,345.334,651,15196,0.57015,0,2,841589,840938,651
6072621,253.377,329.667,671,16656,0.567631,0,2,841829,841158,671
6074081,250.205,315.959,679,17784,0.560427,0,2,842057,841378,679
6077001,247.93,303.964,691,17678,0.566624,0,2,842289,841598,691
6078461,271.938,309.968,779,17598,0.589546,0,2,842729,841950,779
6081381,259.446,293.222,775,17598,0.622103,0,2,842901,842126,775
6082841,282.015,300.57,863,17598,0.66559,0,2,843341,842478,863
6135401,220.513,138.547,2630,8760,0.996427,0,2,852273,849643,2630
6144161,224.591,211.013,1860,10220,0.976917,0,2,853413,851553,1860
6144161,225.017,184.636,2088,10220,0.954803,0,2,853641,851553,2088
6144161,225.39,161.557,2316,11680,0.935452,0,2,853869,851553,2316
6144161,221.216,141.362,2508,11680,0.914771,0,2,854061,851553,2508
6144161,207.064,123.692,2616,13140,0.886674,0,2,854169,851553,2616
6144161,202.181,108.23,2784,1460,0.87459,0,2,854337,851553,2784
6144161,200.909,94.7015,2976,5840,0.866516,0,2,854529,851553,2976
6144161,198.295,82.8638,3156,7300,0.854452,0,2,854709,851553,3156
6144161,200.508,72.5058,3372,8760,0.838895,0,2,854925,851553,3372
6161681,178.445,400.693,698,10220,0.827783,0,2,854949,854251,698
6161681,184.639,350.606,926,11680,0.810561,0,2,855177,854251,926
6161681,187.059,306.78,1130,11680,0.80299,0,2,855381,854251,1130
6161681,187.677,268.433,1322,11680,0.796367,0,2,855573,854251,1322
6163141,216.217,342.879,874,11680,0.788071,0,2,855989,855115,874
6164601,216.19,324.769,892,13140,0.778312,0,2,856205,855313,892
6167521,213.666,308.923,890,14600,0.779773,0,2,856401,855511,890
6170441,234.958,319.807,878,17520,0.781051,0,2,856785,855907,878
6173361,255.088,329.331,878,18478,0.79217,0,2,857181,856303,878
6174821,275.202,337.665,898,18419,0.801899,0,2,857597,856699,898
6176281,267.802,320.207,916,18404,0.820411,0,2,857813,856897,916
6179201,260.327,304.931,926,18404,0.83661,0,2,858021,857095,926
6190881,226.594,125.387,2096,8760,0.958704,0,2,860973,858877,2096
6190881,226.769,109.713,2324,8760,0.962616,0,2,861201,858877,2324
6217161,252.992,279.18,1262,20440,0.98872,0,2,864221,862959,1262
6220081,215.691,311.179,1032,11680,0.992374,0,2,865713,864681,1032
6220081,219.167,122.199,2568,17520,0.990755,0,2,867249,864681,2568
6246361,192.165,327.039,1056,5840,0.978073,0,2,868653,867597,1056
6252201,198.144,358.159,720,5840,0.962064,0,2,868893,868173,720
6253661,241.876,344.889,1016,26257,0.938056,0,2,869441,868425,1016
6256581,224.142,330.278,888,27717,0.912049,0,2,869541,868653,888
6259501,230.624,322.994,892,27674,0.894293,0,2,869817,868925,892
6262421,233.296,316.619,872,27288,0.883756,0,2,870069,869197,872
6265341,228.134,311.042,792,26880,0.877037,0,2,870261,869469,792
6268261,241.617,306.162,856,26322,0.876157,0,2,870597,869741,856
6271181,247.415,301.891,872,26000,0.887888,0,2,870885,870013,872
6274101,246.488,298.155,840,25764,0.900652,0,2,871125,870285,840
6284321,209.162,81.2773,2708,5840,0.981241,0,2,873945,871237,2708
6325201,191.044,104.033,2392,13140,0.99711,0,2,879837,877445,2392
6339801,191.326,291.014,1277,14600,0.994007,0,2,881373,880096,1277
6339801,168.94,114.28,2393,5840,0.987646,0,2,882489,880096,2393
6339801,173.323,99.9951,2597,18980,0.971691,0,2,882693,880096,2597
6363161,214.075,357.028,778,21900,0.977076,0,2,883425,882647,778
6379221,234.22,256.794,1179,35682,0.988462,0,2,884849,883670,1179
6387981,170.502,108.481,2604,29200,0.998566,0,2,889509,886905,2604
6387981,179.189,94.9206,2844,1460,0.984995,0,2,889749,886905,2844
6436161,210.157,335.463,1270,11680,0.997841,0,2,894009,892739,1270
6436161,219.695,172.062,2434,5840,0.995143,0,2,895173,892739,2434
6471201,295.61,359.231,1058,24465,0.995009,0,2,897197,896139,1058
6474121,272.951,317.458,1096,24465,0.992429,0,2,897597,896501,1096
6474121,244.603,243.054,1396,24465,0.990453,0,2,897897,896501,1396
6474121,235.028,212.672,1564,8760,0.990396,0,2,898065,896501,1564
6474121,225.149,186.088,1720,8760,0.987847,0,2,898221,896501,1720
6474121,218.006,162.827,1888,8760,0.985616,0,2,898389,896501,1888
6474121,208.755,142.474,2032,10220,0.986164,0,2,898533,896501,2032
6474121,200.661,124.664,2176,11680,0.986644,0,2,898677,896501,2176
6487261,180.078,283.581,816,13140,0.984563,0,2,898713,897897,816
6513541,223.091,223.24,1512,7300,0.996927,0,2,902673,901161,1512
6516461,234.16,127.296,2988,21900,0.996087,0,2,907718,904730,2988
6516461,235.764,57.1299,4404,24714,0.993244,0,2,909134,904730,4404
6516461,212.537,2.6488,9276,24931,0.995937,0,2,914006,904730,9276
6590921,220.36,831.748,1056,14600,0.998034,0,2,916874,915818,1056
6590921,219.736,326.624,2604,1460,0.997978,0,2,918422,915818,2604
6620121,209.885,396.15,976,13140,0.997842,0,2,919646,918670,976
6621581,214.2,169.479,2300,8760,0.996653,0,2,921218,918918,2300
6640561,199.105,247.457,1512,13140,0.994119,0,2,923174,921662,1512
6735461,171.417,73.1133,2700,5840,0.98875,0,2,936476,933776,2700
6735461,175.615,63.9741,2905,7300,0.983906,0,2,936681,933776,2905
6751681,200.736,334.043,898,8920,0.985178,0,2,937263,936365,898
6751681,185.519,292.287,977,10380,0.984531,0,2,937342,936365,977
6758981,357.1,417.808,1052,16220,0.988387,0,2,939628,938576,1052
6761901,210.645,136.754,2146,11680,0.987758,0,2,940964,938818,2146
6761901,212.814,119.66,2374,11680,0.981789,0,2,941192,938818,2374
6799861,186.215,261.694,1395,14600,0.997785,0,2,945464,944069,1395
6799861,203.641,40.3558,4275,16060,0.992158,0,2,948344,944069,4275
6799861,220.598,15.8476,5871,7300,0.990671,0,2,949940,944069,5871
6799861,180.316,6.22327,6987,14600,0.992586,0,2,951056,944069,6987
6799861,187.777,5.44536,7227,16060,0.964763,0,2,951296,944069,7227
6799861,192.805,4.76469,7455,17520,0.936668,0,2,951524,944069,7455
6799861,197.204,4.16911,7683,18980,0.918334,0,2,951752,944069,7683
6799861,190.553,3.64797,7827,20440,0.902292,0,2,951896,944069,7827
6799861,187.734,3.19197,7995,21900,0.893256,0,2,952064,944069,7995
6799861,176.267,2.79298,8091,23360,0.880349,0,2,952160,944069,8091
6799861,166.234,2.44385,8187,24820,0.871555,0,2,952256,944069,8187
6799861,154.455,2.13837,8259,26280,0.866361,0,2,952328,944069,8259
6799861,151.648,1.87108,8391,27740,0.856816,0,2,952460,944069,8391
6799861,150.692,1.63719,8535,29200,0.850964,0,2,952604,944069,8535
6799861,146.855,1.43254,8655,30660,0.843343,0,2,952724,944069,8655
6799861,144.999,1.25347,8787,31705,0.836675,0,2,952856,944069,8787
6799861,141.874,1.09679,8907,31705,0.833341,0,2,952976,944069,8907
6799861,140.639,0.959691,9039,31705,0.830423,0,2,953108,944069,9039
6799861,139.56,0.83973,9171,31705,0.83037,0,2,953240,944069,9171
6799861,134.115,0.734764,9267,31705,0.830324,0,2,953336,944069,9267
6799861,130.85,0.642918,9375,31705,0.837784,0,2,953444,944069,9375
6799861,129.494,0.562553,9495,31705,0.844311,0,2,953564,944069,9495
6799861,129.807,0.492234,9627,31705,0.855022,0,2,953696,944069,9627
6799861,127.081,0.430705,9735,31705,0.869394,0,2,953804,944069,9735
6799861,233.117,0.00896218,15603,29200,0.994782,0,2,959672,944069,15603
6799861,227.977,0.0078419,15795,30660,0.991685,0,2,959864,944069,15795
6921041,888.287,2021.95,1227,8760,0.995485,0,2,969307,968080,1227
6933481,626.389,813.961,2275,8760,0.992562,0,2,975048,972773,2275
6953921,350.951,423.793,1180,17227,0.995788,0,2,978032,976852,1180
6953921,312.082,370.819,1220,17300,0.995064,0,2,978072,976852,1220
6953921,284.498,190.196,2492,8760,0.974968,0,2,979344,976852,2492
6964141,275.936,377.422,1020,1460,0.943097,0,2,979560,978540,1020
6967061,289.444,366.244,1116,5840,0.91646,0,2,979944,978828,1116
6968521,286.263,381.963,888,8760,0.885653,0,2,980208,979320,888
6968521,269.98,334.218,1044,10220,0.856196,0,2,980364,979320,1044
6968521,263.233,292.441,1260,10220,0.830422,0,2,980580,979320,1260
6968521,258.829,255.886,1488,10220,0.805369,0,2,980808,979320,1488
6969981,279.975,359.4,832,10220,0.790948,0,2,981236,980404,832
6971441,274.978,345.225,826,11680,0.780829,0,2,981476,980650,826
6972901,270.606,332.822,820,13140,0.784476,0,2,981716,980896,820
6974361,269.78,321.969,838,14600,0.797666,0,2,981980,981142,838
6975821,272.058,312.473,880,16060,0.821708,0,2,982268,981388,880
6990421,266.457,263.487,1072,16344,0.948096,0,2,984920,983848,1072
6991881,261.65,261.301,1054,16344,0.953334,0,2,985148,984094,1054
7002101,273.181,273.467,1048,19264,0.976556,0,2,986864,985816,1048
7029841,228.684,130.259,2162,8760,0.997918,0,2,992652,990490,2162
7029841,228.598,113.977,2390,10220,0.978178,0,2,992880,990490,2390
7038601,228.524,311.48,924,20147,0.954656,0,2,993108,992184,924
7038601,225.458,272.545,1128,21607,0.924074,0,2,993312,992184,1128
7038601,225.776,238.477,1356,22165,0.867315,0,2,993540,992184,1356
7038601,214.054,208.667,1488,22165,0.81265,0,2,993672,992184,1488
7038601,208.297,182.584,1656,22165,0.747319,0,1,993840,992184,1656
7041521,192.76,294.386,663,22165,0.685154,0,1,993924,993261,663
7047361,177.665,280.837,549,22165,0.62576,0,1,993996,993447,549
7047361,174.957,245.733,705,22165,0.56379,0,1,994152,993447,705
7050281,178.587,261.516,537,22165,0.502066,0,1,994356,993819,537
7053201,196.764,275.327,489,21086,0.443058,0,1,994680,994191,489
7054661,215.168,287.411,461,20038,0.401426,0,1,995024,994563,461
7057581,212.772,274.734,471,19068,0.367497,0,1,995220,994749,471
7059041,235.176,286.893,491,18239,0.34281,0,1,995612,995121,491
7060501,234.279,274.281,533,17551,0.333709,0,1,995840,995307,533
7063421,232.494,263.246,567,17034,0.335745,0,2,996060,995493,567
7064881,253.932,276.84,599,16659,0.355027,0,2,996464,995865,599
7066341,249.191,265.485,629,16393,0.374399,0,2,996680,996051,629
7067801,248.042,255.55,683,16205,0.406349,0,2,996920,996237,683
7069261,245.537,246.856,725,16158,0.451805,0,2,997148,996423,725
7070721,240.345,239.249,743,16158,0.49658,0,2,997352,996609,743
7072181,238.801,232.593,785,15428,0.548257,0,2,997580,996795,785
7082401,205.365,94.1018,2123,8760,0.907885,0,2,1000272,998149,2123
7082401,209.694,82.3391,2363,8760,0.898149,0,2,1000512,998149,2363
7082401,229.592,16.5845,5243,17520,0.978235,0,2,1003392,998149,5243
7126201,231.869,538.234,1317,13140,0.989144,0,2,1006436,1005119,1317
7126201,207.885,470.954,1357,14600,0.986751,0,2,1006476,1005119,1357
7126201,236.017,241.557,2701,5840,0.954454,0,2,1007820,1005119,2701
7129121,235.015,454.487,984,5840,0.901398,0,2,1008048,1007064,984
7130581,235.638,462.176,708,5840,0.842473,0,2,1008288,1007580,708
7132041,236.183,434.404,708,17520,0.775914,0,2,1008528,1007820,708
7140801,223.161,408.604,612,17520,0.725175,0,2,1008660,1008048,612
7140801,210.265,357.528,732,17520,0.678278,0,2,1008780,1008048,732
7140801,195.982,312.837,828,18980,0.642243,0,2,1008876,1008048,828
7140801,195.484,273.733,1020,20440,0.608213,0,2,1009068,1008048,1020
7140801,177.049,239.516,1068,20440,0.580936,0,2,1009116,1008048,1068
7140801,165.418,209.576,1152,21900,0.549569,0,2,1009200,1008048,1152
7140801,162.741,183.379,1296,23360,0.529623,0,2,1009344,1008048,1296
7140801,164.898,160.457,1476,24820,0.51217,0,2,1009524,1008048,1476
7152481,162.286,287.4,444,26280,0.496899,0,2,1009668,1009224,444
7155401,175,266.725,586,26970,0.483536,0,2,1009932,1009346,586
7158321,184.625,263.884,594,26040,0.476844,0,2,1010184,1009590,594
7161241,193.047,261.399,602,28173,0.475989,0,2,1010436,1009834,602
7164161,198.916,259.224,598,27505,0.48024,0,2,1010676,1010078,598
7167081,204.052,254.196,619,26908,0.49146,0,2,1010916,1010297,619
7170001,202.545,246.671,617,26431,0.501278,0,2,1011108,1010491,617
7172921,205.727,240.087,651,26026,0.512368,0,2,1011336,1010685,651
7175841,205.511,234.327,661,25763,0.532072,0,2,1011540,1010879,661
7178761,206.822,229.286,683,25572,0.559313,0,2,1011756,1011073,683
7181681,207.969,224.875,705,25453,0.590649,0,2,1011972,1011267,705
7184601,207.473,221.016,715,25429,0.620568,0,2,1012176,1011461,715
7187521,213.039,217.639,773,25429,0.651747,0,2,1012428,1011655,773
7210881,299.93,397.467,1020,7300,0.982122,0,2,1018440,1017420,1020
7243001,192.941,337.537,1363,16060,0.991639,0,2,1021440,1020077,1363
7243001,205.474,226.124,2059,18980,0.993149,0,2,1022136,1020077,2059
7243001,188.79,197.858,2131,20440,0.992755,0,2,1022208,1020077,2131
7243001,213.816,173.126,2520,5840,0.992411,0,2,1022597,1020077,2520
7243001,212.589,151.485,2724,5840,0.97961,0,2,1022801,1020077,2724
7243001,213.016,132.549,2940,20440,0.958408,0,2,1023017,1020077,2940
7243001,211.264,115.981,3139,21900,0.936107,0,2,1023216,1020077,3139
7245921,236.356,446.483,791,22840,0.899094,0,2,1023628,1022837,791
7248841,214.311,400.423,773,24300,0.866707,0,2,1023688,1022915,773
7250301,193.522,360.12,743,25760,0.833369,0,2,1023736,1022993,743
7260521,178.332,324.855,737,27220,0.804198,0,2,1023808,1023071,737
7267821,163.541,293.998,719,28680,0.771173,0,2,1023868,1023149,719
7271681,152.098,266.998,713,30140,0.744776,0,2,1023940,1023227,713
7274601,555.836,695.624,399,31600,0.684179,0,1,1027322,1026923,399
7277521,510.356,628.171,435,34520,0.628657,0,1,1027514,1027079,435
7280441,467.812,569.149,449,34215,0.581325,0,1,1027684,1027235,449
7283361,427.835,517.506,441,32792,0.541159,0,1,1027832,1027391,441
7286281,395.356,472.317,453,31520,0.497264,0,1,1028000,1027547,453
7289201,365.686,432.778,455,30471,0.458856,0,1,1028158,1027703,455
7292121,337.976,398.181,443,29573,0.432749,0,1,1028302,1027859,443
7295041,319.729,367.908,479,28712,0.412406,0,1,1028494,1028015,479
7297961,296.263,341.419,455,28113,0.397105,0,1,1028626,1028171,455
7300881,280.23,318.242,467,30397,0.393717,0,2,1028794,1028327,467
7303801,267.701,297.962,491,29910,0.395752,0,2,1028974,1028483,491
7306721,255.238,280.217,503,29610,0.415033,0,2,1029142,1028639,503
7309641,239.834,260.689,511,29386,0.441904,0,2,1029274,1028763,511
7312561,229.354,243.603,543,29236,0.482916,0,2,1029430,1028887,543
7315481,223.185,228.653,599,29236,0.531301,0,2,1029610,1029011,599
7334461,192.435,49.6376,2707,16060,0.929662,0,2,1032586,1029879,2707
7337381,244.368,18.1919,6768,5840,0.986219,0,2,1039630,1032862,6768
7340301,257.322,822.918,660,5840,0.940442,0,2,1039978,1039318,660
7341761,267.156,743.803,806,5840,0.886637,0,2,1040314,1039508,806
7360741,250.262,674.578,748,5840,0.837057,0,2,1040446,1039698,748
7372421,238.479,614.006,714,14832,0.783675,0,2,1040602,1039888,714
7398701,220.669,561.005,620,16292,0.731966,0,2,1040698,1040078,620
7401621,227.586,520.379,660,16502,0.67422,0,1,1040974,1040314,660
7404541,239.637,502.832,604,16349,0.621192,0,1,1041298,1040694,604
7407461,251.683,487.478,560,16103,0.577293,0,1,1041634,1041074,560
7408921,269.222,474.043,572,15160,0.546382,0,2,1042026,1041454,572
7410381,261.07,438.538,586,14929,0.516834,0,2,1042230,1041644,586
7411841,258.436,408.846,625,14755,0.49348,0,2,1042470,1041845,625
7414761,250.631,382.865,620,14668,0.475545,0,2,1042666,1042046,620
7417681,268.802,385.257,614,14595,0.462352,0,2,1043062,1042448,614
7419141,287.202,387.35,628,14508,0.453308,0,2,1043478,1042850,628
7422061,277.302,364.056,635,14465,0.445394,0,2,1043686,1043051,635
7423521,291.639,368.799,625,14436,0.44097,0,2,1044078,1043453,625
7424981,283.684,347.824,652,15896,0.449599,0,2,1044306,1043654,652
7426441,276.724,329.471,679,17312,0.452149,0,2,1044534,1043855,679
7427901,269.133,313.412,694,17312,0.46688,0,2,1044750,1044056,694
7430821,259.992,299.361,689,17312,0.48977,0,2,1044946,1044257,689
7433741,273.993,302.191,739,17312,0.534799,0,2,1045318,1044579,739
7443961,243.176,101.193,2535,8760,0.913013,0,2,1048402,1045867,2535
7479001,487.818,622.521,2491,22187,0.995438,0,2,1062808,1060317,2491
7479001,331.678,279.385,3727,10220,0.991702,0,2,1064044,1060317,3727
7479001,320.218,244.462,3967,11680,0.98649,0,2,1064284,1060317,3967
7531561,233.483,637.602,957,14600,0.996104,0,2,1068400,1067443,957
7541781,267.409,432.736,1133,18050,0.958252,0,2,1070160,1069027,1133
7543241,260.983,403.394,1151,18050,0.92222,0,2,1070376,1069225,1151
7543241,230.36,352.97,1167,18050,0.890693,0,2,1070392,1069225,1167
7543241,228.565,308.848,1383,18050,0.850606,0,2,1070608,1069225,1383
7543241,217.994,270.242,1527,18050,0.81053,0,2,1070752,1069225,1527
7543241,210.245,236.462,1683,5840,0.767964,0,2,1070908,1069225,1683
7543241,198.964,206.904,1803,5840,0.723219,0,2,1071028,1069225,1803
7543241,193.594,181.041,1959,5840,0.686566,0,2,1071184,1069225,1959
7553461,184.395,349.286,552,7300,0.654495,0,2,1071304,1070752,552
7556381,195.845,325.125,672,20970,0.626433,0,2,1071580,1070908,672
7557841,223.365,333.985,692,22923,0.609379,0,2,1071996,1071304,692
7560761,215.444,316.987,654,22923,0.594457,0,2,1072156,1071502,654
7563681,227.514,314.363,670,22923,0.5889,0,2,1072468,1071798,670
7566601,232.074,309.568,658,22978,0.606537,0,2,1072732,1072074,658
7569521,245.065,305.372,718,22533,0.61697,0,2,1073068,1072350,718
7572441,256.432,301.45,780,22258,0.641099,0,2,1073404,1072624,780
7575361,260.378,297.769,796,22156,0.667212,0,2,1073692,1072896,796
7589961,236.469,1.24605,9860,15656,0.990535,0,2,1084192,1074332,9860
7589961,245.911,1.09029,10172,5840,0.961718,0,2,1084504,1074332,10172
7589961,257.172,0.954005,10508,5840,0.917753,0,2,1084840,1074332,10508
7589961,247.525,0.834754,10688,5840,0.869284,0,2,1085020,1074332,10688
7629381,605.085,1653.98,570,20513,0.854373,0,2,1088128,1087558,570
7649821,563.949,1475.11,623,17997,0.861327,0,2,1088404,1087781,623
7667341,306.388,467.827,1139,17888,0.968319,0,2,1091496,1090357,1139
7667341,271.59,409.349,1167,19348,0.963529,0,2,1091524,1090357,1167
7667341,246.811,183.714,2547,10220,0.982382,0,2,1092904,1090357,2547
7684861,242.328,367.481,1369,11680,0.987093,0,2,1094332,1092963,1369
7711141,213.244,291.045,1358,11680,0.976607,0,2,1098844,1097486,1358
7712601,238.589,340.664,1086,11680,0.934531,0,2,1099260,1098174,1086
7712601,210.765,298.081,1102,5840,0.900215,0,2,1099276,1098174,1102
7712601,211.419,260.821,1318,5840,0.857688,0,2,1099492,1098174,1318
7712601,196.992,228.219,1414,5840,0.811727,0,2,1099588,1098174,1414
7712601,184.368,199.691,1510,3980,0.774011,0,2,1099684,1098174,1510
7712601,174.322,174.73,1614,3980,0.72976,0,2,1099788,1098174,1614
7720961,193.032,329.639,524,21838,0.69729,0,2,1100112,1099588,524
7720961,186.403,288.434,664,23121,0.673878,0,2,1100252,1099588,664
7723881,203.602,289.38,692,23121,0.660894,0,2,1100576,1099884,692
7725341,222.652,296.207,704,22340,0.657032,0,2,1100932,1100228,704
7728261,220.821,280.681,740,23800,0.663653,0,2,1101140,1100400,740
7729721,240.718,288.596,776,24122,0.681946,0,2,1101520,1100744,776
7731181,236.128,274.022,808,23766,0.702953,0,2,1101724,1100916,808
7734101,226.612,261.269,796,23528,0.738834,0,2,1101884,1101088,796
7744321,239.063,104.668,2568,8760,0.926132,0,2,1104752,1102184,2568
7744321,239.18,91.5846,2808,1460,0.930365,0,2,1104992,1102184,2808
7777901,260.751,328.986,1116,11680,0.991556,0,2,1109140,1108024,1116
7779361,258.157,308.612,1190,13140,0.986362,0,2,1109380,1108190,1190
7779361,230.887,270.036,1230,14600,0.986816,0,2,1109420,1108190,1230
7782281,226.781,137.462,2472,16060,0.980177,0,2,1112264,1109792,2472
7782281,228.433,120.28,2712,5840,0.955154,0,2,1112504,1109792,2712
7782281,228.379,105.245,2940,17520,0.92951,0,2,1112732,1109792,2940
7782281,210.332,92.0891,3024,18980,0.897071,0,2,1112816,1109792,3024
7782281,206.54,80.5779,3204,20159,0.856187,0,2,1112996,1109792,3204
7798341,212.223,410.756,734,20159,0.802914,0,2,1113248,1112514,734
7798341,197.695,359.411,830,20159,0.7513,0,2,1113344,1112514,830
7804181,189.483,361.485,586,20159,0.686137,0,1,1113476,1112890,586
7807101,186.798,339.799,566,20159,0.62662,0,1,1113644,1113078,566
7811481,175.448,320.824,474,20159,0.567043,0,1,1113740,1113266,474
7814401,185.017,304.221,538,20159,0.514912,0,1,1113992,1113454,538
7817321,205.39,313.194,510,19320,0.469298,0,1,1114340,1113830,510
7818781,228.716,321.044,526,18528,0.426886,0,1,1114732,1114206,526
7821701,221.627,304.414,510,17876,0.397275,0,1,1114904,1114394,510
7824621,240.423,313.362,506,17270,0.373866,0,1,1115276,1114770,506
7827541,261.37,321.192,538,16727,0.355883,0,1,1115684,1115146,538
7830461,278.199,328.043,558,19243,0.350147,0,2,1116080,1115522,558
7833381,288.424,329.288,580,18917,0.352629,0,2,1116440,1115860,580
7836301,289.871,325.627,580,18684,0.3673,0,2,1116740,1116160,580
7839221,297.137,322.423,628,18482,0.388888,0,2,1117088,1116460,628
7842141,303.495,319.62,676,18389,0.424027,0,2,1117436,1116760,676
7842641,312.058,317.168,748,18389,0.477273,0,2,1117808,1117060,748
7852861,221.727,2.47976,9082,5840,0.987809,0,2,1127628,1118546,9082
7852861,230.011,2.16979,9370,5840,0.963083,0,2,1127916,1118546,9370
7906881,803.891,1335.42,1251,25043,0.97586,0,2,1135616,1134365,1251
7906881,402.679,458.863,2719,10220,0.979205,0,2,1137084,1134365,2719
7930241,292.115,379.641,1424,14600,0.983279,0,2,1139688,1138264,1424
7930241,285.601,332.186,1664,16060,0.969119,0,2,1139928,1138264,1664
7930241,278.401,290.662,1892,14600,0.96298,0,2,1140156,1138264,1892
7930241,239.429,194.721,2384,13140,0.971449,0,2,1140648,1138264,2384
7934621,224,331.083,1056,13140,0.969391,0,2,1140984,1139928,1056
7934621,214,289.698,1200,14600,0.961967,0,2,1141128,1139928,1200
7937541,200.75,311.986,840,16060,0.947971,0,2,1141236,1140396,840
7937541,193.656,272.987,984,16060,0.940725,0,2,1141380,1140396,984
7939001,176.949,268.864,804,17520,0.931884,0,2,1141440,1140636,804
7940461,174.331,250.256,840,17520,0.924149,0,2,1141596,1140756,840
7943381,163.039,233.974,804,17520,0.91488,0,2,1141680,1140876,804
7953601,156.159,219.727,792,17520,0.90927,0,2,1141788,1140996,792
7956521,160.639,207.261,864,27276,0.904361,0,2,1141980,1141116,864
7959441,170.56,211.354,864,27276,0.910066,0,2,1142220,1141356,864
7988641,196.407,108.84,2589,1460,0.995361,0,2,1148172,1145583,2589
8010541,189.433,263.935,1286,13140,0.995678,0,2,1149492,1148206,1286
8010541,195.754,230.943,1526,13140,0.993719,0,2,1149732,1148206,1526
8016381,361.789,687.892,755,1460,0.963008,0,2,1154246,1153491,755
8037121,399.065,696.28,660,5840,0.911382,0,2,1154906,1154246,660
8040041,668.682,908.245,824,7300,0.92121,0,2,1157462,1156638,824
8048801,311.332,218.909,2688,17520,0.97413,0,2,1160342,1157654,2688
8069241,222.63,373.241,1044,14600,0.989861,0,2,1161746,1160702,1044
8105741,234.936,304.101,989,10220,0.99714,0,2,1167650,1166661,989
8107201,260.569,306.964,1102,11680,0.966248,0,2,1168090,1166988,1102
8107201,232.998,268.593,1142,5840,0.942967,0,2,1168130,1166988,1142
8107201,233.873,235.019,1382,5840,0.908846,0,2,1168370,1166988,1382
8107201,233.139,205.642,1610,5840,0.86649,0,2,1168598,1166988,1610
8107201,223.497,179.936,1766,4380,0.816929,0,2,1168754,1166988,1766
8107201,227.06,157.444,2018,4380,0.761063,0,2,1169006,1166988,2018
8115961,219.677,339.014,576,18980,0.70968,0,2,1169174,1168598,576
8118881,228.218,319.387,682,21065,0.66222,0,2,1169462,1168780,682
8121801,240.19,330.464,598,20439,0.635692,0,2,1169786,1169188,598
8123261,260.667,334.656,638,19717,0.619981,0,2,1170190,1169552,638
8126181,257.083,315.574,688,19172,0.613733,0,2,1170422,1169734,688
8127641,275.448,321.627,728,18803,0.628267,0,2,1170826,1170098,728
8129101,269.517,304.174,774,18546,0.653483,0,2,1171054,1170280,774
8132021,261.827,288.902,800,18398,0.683048,0,2,1171262,1170462,800
8142241,242.22,120.118,2272,8760,0.93366,0,2,1174190,1171918,2272
8142241,241.942,105.103,2512,10220,0.929453,0,2,1174430,1171918,2512
8142241,242.343,47.1699,3988,10220,0.964589,0,2,1175906,1171918,3988
8181661,236.913,202.381,2648,5840,0.992493,0,2,1181942,1179294,2648
8181661,258.299,177.083,3056,1460,0.958431,0,2,1182350,1179294,3056
8181661,278.512,154.948,3476,5840,0.907377,0,2,1182770,1179294,3476
8190421,257.198,491.329,738,17801,0.855205,0,2,1182878,1182140,738
8197721,243.048,458.413,654,17801,0.804555,0,2,1183022,1182368,654
8197721,230.667,401.111,798,17801,0.760235,0,2,1183166,1182368,798
8199181,247.834,407.972,710,17801,0.706456,0,2,1183534,1182824,710
8202101,239.855,385.476,666,17340,0.666899,0,2,1183718,1183052,666
8203561,260.373,394.291,614,16866,0.642287,0,2,1184122,1183508,614
8205021,262.326,373.505,662,16367,0.635751,0,2,1184398,1183736,662
8206481,265.535,355.317,722,16008,0.647532,0,2,1184686,1183964,722
8207941,268.343,339.402,782,15790,0.67534,0,2,1184974,1184192,782
8218161,262.348,159.293,2058,7300,0.921516,0,2,1187846,1185788,2058
8218161,259.554,139.382,2298,7300,0.912577,0,2,1188086,1185788,2298
8226921,235.188,195.764,1764,10220,0.955765,0,2,1189370,1187606,1764
8238601,254.73,281.113,1103,14600,0.966061,0,2,1190746,1189643,1103
8240061,252.889,275.599,1106,15209,0.967804,0,2,1190986,1189880,1106
8250281,265.113,236.916,1626,11680,0.99028,0,2,1193600,1191974,1626
8264881,282.943,321.864,1064,5840,0.974578,0,2,1196080,1195016,1064
8267801,281.075,310.506,1101,5840,0.934005,0,2,1196348,1195247,1101
8269261,299.441,336.692,1009,15111,0.876005,0,2,1196776,1195767,1009
8272181,289.511,333.731,916,15111,0.822754,0,2,1196996,1196080,916
8273641,305.322,364.265,754,15101,0.77366,0,2,1197412,1196658,754
8275101,297.157,354.856,705,16561,0.723202,0,2,1197652,1196947,705
8276561,290.012,346.624,656,17066,0.681552,0,2,1197892,1197236,656
8278021,288.261,339.421,643,16594,0.650108,0,2,1198168,1197525,643
8279481,285.228,325.619,678,16161,0.625095,0,2,1198432,1197754,678
8280941,276.574,313.541,665,15842,0.605708,0,2,1198648,1197983,665
8282401,276.503,302.974,712,15549,0.601244,0,2,1198924,1198212,712
8283861,270.44,293.727,711,15358,0.604839,0,2,1199152,1198441,711
8285321,269.635,285.636,746,15192,0.615484,0,2,1199416,1198670,746
8286781,265.93,278.557,757,16652,0.637298,0,2,1199656,1198899,757
8288241,265.689,272.362,792,17959,0.653886,0,2,1199920,1199128,792
8289701,265.478,266.942,827,17959,0.6834,0,2,1200184,1199357,827
8291161,265.293,262.199,862,17959,0.719225,0,2,1200448,1199586,862
8301381,227.235,91.8393,2489,11680,0.941766,0,2,1203356,1200867,2489
8301381,216.947,41.217,3737,10220,0.970115,0,2,1204604,1200867,3737
8301381,219.829,36.0649,3977,11680,0.955101,0,2,1204844,1200867,3977
8301381,236.463,5.56157,7373,13140,0.991826,0,2,1208240,1200867,7373
8301381,236.684,1.1202,10186,5840,0.989604,0,2,1211053,1200867,10186
8361241,357.293,510.332,2338,7300,0.996015,0,2,1216450,1214112,2338
8378761,289.296,172.791,2993,5840,0.998338,0,2,1221039,1218046,2993
8406501,256.498,252.899,1518,5840,0.998457,0,2,1224416,1222898,1518
8416721,283.491,346.292,1027,20457,0.997959,0,2,1225869,1224842,1027
8425481,252.177,141.471,2401,7300,0.99828,0,2,1228590,1226189,2401
8448841,296.587,443.159,971,8760,0.998485,0,2,1232783,1231812,971
8451761,280.549,204.545,2384,5840,0.990655,0,2,1234672,1232288,2384
8466361,283.24,320.176,1195,5840,0.99508,0,2,1236691,1235496,1195
8475121,280.123,377.221,864,1460,0.987477,0,2,1238064,1237200,864
8478041,294.532,357.997,972,7300,0.987912,0,2,1238760,1237788,972
8491181,262.533,238.813,1435,17978,0.99662,0,2,1242129,1240694,1435
8518921,313.618,384.553,1285,13140,0.994795,0,2,1248530,1247245,1285
8529141,268.843,380.137,1044,5840,0.991706,0,2,1250122,1249078,1044
8584621,276.327,290.769,1134,18929,0.997465,0,2,1261278,1260144,1134
8586081,276.286,283.423,1178,18929,0.996532,0,2,1261554,1260376,1178
8628421,254.064,156.236,2633,5840,0.998722,0,2,1270446,1267813,2633
8628421,252.306,136.706,2873,7300,0.988881,0,2,1270686,1267813,2873
8637181,250.768,415.118,749,8760,0.989021,0,2,1270926,1270177,749
8680981,238.682,133.493,2358,8760,0.987397,0,2,1279602,1277244,2358
8680981,237.346,116.807,2586,1460,0.986473,0,2,1279830,1277244,2586
8705801,246.534,274.952,1150,18980,0.985636,0,2,1282574,1281424,1150
8707261,231.531,119.753,2432,1460,0.990609,0,2,1284066,1281634,2432
8707261,232.59,104.784,2672,5840,0.990533,0,2,1284306,1281634,2672
8724781,213.266,143.159,2235,11680,0.99604,0,2,1287138,1284903,2235
8724781,229.556,64.2489,3723,10220,0.988223,0,2,1288626,1284903,3723
8755441,226.621,416.177,1224,13140,0.980128,0,2,1291470,1290246,1224
8783181,186.966,36.8775,3915,16060,0.994917,0,2,1299073,1295158,3915
8783181,189.095,32.2679,4119,17520,0.981802,0,2,1299277,1295158,4119
8783181,189.459,28.2344,4311,18980,0.969077,0,2,1299469,1295158,4311
8783181,189.776,24.7051,4503,20440,0.966692,0,2,1299661,1295158,4503
8783181,182.554,21.6169,4635,21900,0.964606,0,2,1299793,1295158,4635
8783181,176.235,18.9148,4767,1460,0.96528,0,2,1299925,1295158,4767
8783181,175.206,16.5505,4935,5840,0.96837,0,2,1300093,1295158,4935
8835741,180.765,312.937,1172,20440,0.990676,0,2,1302165,1300993,1172
8847421,146.163,159.509,1284,18980,0.995818,0,2,1305313,1304029,1284
8847421,204.179,2.9042,7020,16060,0.988674,0,2,1311049,1304029,7020
8847421,207.157,2.54118,7248,17520,0.98134,0,2,1311277,1304029,7248
8847421,228.51,1.30339,8508,5840,0.975429,0,2,1312537,1304029,8508
8847421,229.946,1.14047,8748,5840,0.95475,0,2,1312777,1304029,8748
8847421,228.203,0.99791,8964,5840,0.942906,0,2,1312993,1304029,8964
8863481,480.178,1316.75,681,23360,0.946293,0,2,1315237,1314556,681
8937941,266.875,447.486,1020,1460,0.982968,0,2,1318273,1317253,1020
8984661,248.798,146.701,2257,5840,0.971091,0,2,1326673,1324416,2257
8984661,246.198,128.363,2485,1460,0.920955,0,2,1326901,1324416,2485
8994881,242.423,319.443,1044,5840,0.879585,0,2,1327117,1326073,1044
8997801,248.12,324.512,972,19378,0.840887,0,2,1327405,1326433,972
8997801,229.105,283.948,1068,19378,0.797026,0,2,1327501,1326433,1068
8997801,219.967,248.455,1224,19378,0.753648,0,2,1327657,1326433,1224
8997801,216.471,217.398,1416,19378,0.713192,0,2,1327849,1326433,1416
9000721,238.912,326.848,719,19378,0.692793,0,2,1328245,1327526,719
9002181,264.048,343.742,697,18710,0.692444,0,2,1328685,1327988,697
9003641,265.542,329.649,742,18093,0.702138,0,2,1328961,1328219,742
9005101,266.849,317.318,787,17626,0.715621,0,2,1329237,1328450,787
9006561,269.493,306.528,844,16244,0.739918,0,2,1329525,1328681,844
9008021,270.307,297.087,889,16047,0.771179,0,2,1329801,1328912,889
9028461,231.407,176.036,1848,13140,0.975566,0,2,1333945,1332097,1848
9048901,277.442,299.378,1122,14600,0.988125,0,2,1337013,1335891,1122
9067881,247.98,239.804,1219,19333,0.989157,0,2,1340145,1338926,1219
9067881,221.983,209.829,1259,5840,0.983013,0,2,1340185,1338926,1259
9067881,224.235,183.6,1499,5840,0.966386,0,2,1340425,1338926,1499
9067881,226.205,160.65,1739,5840,0.949338,0,2,1340665,1338926,1739
9067881,214.43,140.569,1871,4380,0.926921,0,2,1340797,1338926,1871
9067881,208.626,122.998,2039,4380,0.904805,0,2,1340965,1338926,2039
9076641,238.048,324.998,744,4380,0.860455,0,2,1341409,1340665,744
9079561,253.292,314.498,863,20667,0.814148,0,2,1341769,1340906,863
9082481,265.13,338.061,708,20219,0.756129,0,2,1342117,1341409,708
9083941,279.489,347.803,672,19562,0.712863,0,2,1342497,1341825,672
9085401,271.553,330.328,680,18918,0.680005,0,2,1342713,1342033,680
9086861,264.609,315.037,688,18372,0.656255,0,2,1342929,1342241,688
9088321,257.033,301.657,684,17911,0.642973,0,2,1343133,1342449,684
9089781,250.404,289.95,680,17491,0.638851,0,2,1343337,1342657,680
9091241,250.603,279.706,724,17127,0.645245,0,2,1343589,1342865,724
9092701,250.778,270.743,768,16875,0.668339,0,2,1343841,1343073,768
9094161,247.931,262.9,788,16735,0.696047,0,2,1344069,1343281,788
9105841,237.806,116.361,2212,7300,0.938931,0,2,1347157,1344945,2212
9123361,236.328,380.351,864,10220,0.972269,0,2,1348825,1347961,864
9129201,255.193,304.439,1154,16060,0.975776,0,2,1350225,1349071,1154
9155481,251.727,267.828,1115,5840,0.99281,0,2,1354533,1353418,1115
9156941,250.261,265.474,1106,5840,0.969959,0,2,1354773,1353667,1106
9158401,248.978,263.415,1097,5840,0.939964,0,2,1355013,1353916,1097
9159861,247.856,255.363,1138,5840,0.896219,0,2,1355253,1354115,1138
9162781,260.874,275.693,1072,5840,0.842941,0,2,1355605,1354533,1072
9165701,259.765,303.481,826,20436,0.786324,0,2,1355857,1355031,826
9168621,279.794,337.296,672,20202,0.724283,0,1,1356277,1355605,672
9171541,288.32,344.884,622,19640,0.667498,0,1,1356625,1356003,622
9174461,294.28,351.524,560,19079,0.615311,0,1,1356961,1356401,560
9175921,307.995,357.333,566,18494,0.574647,0,1,1357365,1356799,566
9178841,296.996,337.541,587,17991,0.546566,0,2,1357585,1356998,587
9180301,310.371,345.099,593,17582,0.544495,0,2,1357989,1357396,593
9181761,301.575,326.836,634,17231,0.547683,0,2,1358229,1357595,634
9183221,296.878,310.857,699,16985,0.560473,0,2,1358493,1357794,699
9184681,292.768,296.875,764,16868,0.584164,0,2,1358757,1357993,764
9186141,281.672,284.64,769,16856,0.614893,0,2,1358961,1358192,769
9187601,274.963,273.935,798,16856,0.654282,0,2,1359189,1358391,798
9197821,234.45,102.517,2373,10220,0.929071,0,2,1362157,1359784,2373
9237241,260.963,270.837,1133,15905,0.994455,0,2,1367769,1366636,1133
9240161,246.441,154.111,2043,8760,0.982511,0,2,1369153,1367110,2043
9240161,245.636,134.847,2283,5840,0.944697,0,2,1369393,1367110,2283
9247461,244.931,343.366,720,1460,0.90286,0,2,1369633,1368913,720
9247461,286.315,300.446,1296,18825,0.848753,0,2,1370209,1368913,1296
9250381,270.026,375.765,549,18825,0.791409,0,2,1370365,1369816,549
9251841,283.772,357.294,701,18839,0.753733,0,2,1370745,1370044,701
9253301,275.301,341.132,689,18839,0.725766,0,2,1370961,1370272,689
9254761,270.888,326.991,701,18839,0.703795,0,2,1371201,1370500,701
9256221,265.527,314.617,701,18226,0.694571,0,2,1371429,1370728,701
9257681,266.836,303.79,749,17690,0.693999,0,2,1371705,1370956,749
9259141,261.982,294.316,749,17295,0.7035,0,2,1371933,1371184,749
9260601,265.234,286.027,809,16950,0.721812,0,2,1372221,1371412,809
9262061,265.08,278.773,845,16746,0.752836,0,2,1372485,1371640,845
9279581,248.796,232.602,1178,19462,0.941467,0,2,1375509,1374331,1178
9279581,222.696,203.526,1218,19462,0.943784,0,2,1375549,1374331,1218
9305861,248.137,325.526,974,10220,0.993053,0,2,1379929,1378955,974
9326301,211.682,311.483,1211,14600,0.993929,0,2,1382869,1381658,1211
9326301,215.222,272.547,1451,14600,0.972188,0,2,1383109,1381658,1451
9326301,218.319,238.479,1691,5840,0.959414,0,2,1383349,1381658,1691
9326301,215.029,208.669,1883,5840,0.948237,0,2,1383541,1381658,1883
9326301,206.151,182.585,2027,5840,0.935958,0,2,1383685,1381658,2027
9326301,189.382,159.762,2099,4380,0.927713,0,2,1383757,1381658,2099
9326301,177.709,139.792,2195,4380,0.915499,0,2,1383853,1381658,2195
9327761,227.495,375.693,744,1460,0.897312,0,2,1384429,1383685,744
9336521,214.058,344.231,740,20433,0.883898,0,2,1384549,1383809,740
9337981,230.301,316.702,960,21893,0.87966,0,2,1384893,1383933,960
9337981,202.014,277.115,964,23353,0.875953,0,2,1384897,1383933,964
9337981,205.262,242.475,1192,23353,0.882709,0,2,1385125,1383933,1192
9337981,196.104,212.166,1324,23353,0.88862,0,2,1385257,1383933,1324
9340901,207.591,278.645,868,23353,0.901293,0,2,1385545,1384677,868
9364261,240.165,229.873,1360,13140,0.989827,0,2,1389961,1388601,1360
9371561,235.464,109.61,2790,1460,0.996701,0,2,1392865,1390075,2790
9394921,230.584,321.577,1048,13140,0.996019,0,2,1394221,1393173,1048
9394921,228.912,126.282,2644,23360,0.983437,0,2,1395817,1393173,2644
9394921,237.798,110.497,2944,1460,0.984257,0,2,1396117,1393173,2944
9394921,235.073,96.6847,3160,5840,0.984975,0,2,1396333,1393173,3160
9409521,203.731,382.894,840,5840,0.989943,0,2,1396957,1396117,840
9413901,182.794,321.981,822,5840,0.98605,0,2,1397185,1396363,822
9419741,203.445,322.983,840,5840,0.976544,0,2,1397533,1396693,840
9429961,235.132,265.644,1103,24803,0.981973,0,2,1399170,1398067,1103
9431421,234.241,254.688,1153,24803,0.980476,0,2,1399398,1398245,1153
9431421,206.961,222.852,1169,24803,0.979167,0,2,1399414,1398245,1169
9431421,196.983,149.294,1703,10220,0.984793,0,2,1399948,1398245,1703
9431421,179.19,114.303,1945,10220,0.987107,0,2,1400190,1398245,1945
9431421,169.63,87.5132,2221,11680,0.982629,0,2,1400466,1398245,2221
9431421,164.926,76.574,2353,13140,0.9773,0,2,1400598,1398245,2353
9446021,145.811,258.127,836,14600,0.972638,0,2,1400610,1399774,836
9448941,172.584,247.611,1022,26298,0.961058,0,2,1400970,1399948,1022
9451861,189.136,261.16,971,26298,0.927176,0,2,1401275,1400304,971
9454781,200.619,269.015,928,26298,0.891279,0,2,1401556,1400628,928
9456721,203.667,270.888,869,26298,0.843619,0,2,1401781,1400912,869
9459641,539.708,657.277,399,25949,0.738167,0,1,1404673,1404274,399
9462561,513.37,610.617,444,24388,0.657146,0,1,1405002,1404558,444
9465481,479.199,569.79,400,23155,0.586253,0,1,1405242,1404842,400
9468401,459.799,534.066,440,21964,0.534221,0,1,1405566,1405126,440
9471321,441.324,502.808,468,21019,0.503693,0,1,1405878,1405410,468
9474241,431.158,475.457,544,20275,0.509482,0,2,1406238,1405694,544
9475701,424.764,451.525,640,19802,0.542046,0,2,1406618,1405978,640
9477161,397.168,412.834,702,19637,0.588041,0,2,1406822,1406120,702
9487381,267.994,138.38,2292,10220,0.897671,0,2,1409406,1407114,2292
9501981,232.723,473.533,1714,14600,0.993349,0,2,1415214,1413500,1714
9501981,233.632,414.342,1954,16060,0.98793,0,2,1415454,1413500,1954
9501981,226.284,185.955,3262,7300,0.990833,0,2,1416762,1413500,3262
9535561,227.998,481.21,954,5840,0.979479,0,2,1417002,1416048,954
9535561,227.998,421.059,1182,5840,0.974544,0,2,1417230,1416048,1182
9542861,220.499,432.427,838,5840,0.963976,0,2,1417398,1416560,838
9545781,249.936,406.248,1071,5840,0.932229,0,2,1417854,1416783,1071
9547241,264.694,411.217,993,16703,0.91945,0,2,1418222,1417229,993
9548701,257.108,387.69,974,18163,0.918269,0,2,1418426,1417452,974
9579361,242.414,198.464,1840,7300,0.995434,0,2,1424202,1422362,1840
9589581,238.582,181.58,1884,13140,0.993207,0,2,1425846,1423962,1884
9608561,238.309,180.304,1786,5840,0.994882,0,2,1428702,1426916,1786
9608561,238.521,157.766,2026,5840,0.993022,0,2,1428942,1426916,2026
9617321,247.706,331.295,792,1460,0.992644,0,2,1429254,1428462,792
9618781,274.742,316.383,1044,5840,0.982313,0,2,1429718,1428674,1044
9621701,267.9,303.335,1052,7300,0.973274,0,2,1429938,1428886,1052
9621701,243.412,265.418,1124,10220,0.965365,0,2,1430010,1428886,1124
9621701,239.986,232.241,1340,10220,0.958444,0,2,1430226,1428886,1340
9621701,235.487,203.211,1544,10220,0.947389,0,2,1430430,1428886,1544
9621701,224.051,177.81,1688,10220,0.940215,0,2,1430574,1428886,1688
9623161,251.045,298.958,981,10220,0.928938,0,2,1431014,1430033,981
9624621,246.664,290.089,969,11680,0.916571,0,2,1431230,1430261,969
9626081,242.831,282.327,957,13140,0.90825,0,2,1431446,1430489,957
9629001,238.477,275.537,937,14600,0.903468,0,2,1431654,1430717,937
9630461,259.168,298.094,885,17391,0.894285,0,2,1432058,1431173,885
9631921,259.772,289.333,921,18851,0.893749,0,2,1432322,1431401,921
9633381,258.8,281.666,945,20106,0.893281,0,2,1432574,1431629,945
9634841,254.95,274.958,945,20093,0.902871,0,2,1432802,1431857,945
9665501,217.591,76.296,3016,7300,0.994896,0,2,1440206,1437190,3016
9665501,220.392,66.759,3256,8760,0.994284,0,2,1440446,1437190,3256
9690321,223.016,278.399,1161,14600,0.990255,0,2,1441966,1440805,1161
9691781,210.26,104.3,2537,5840,0.990402,0,2,1443518,1440981,2537
9691781,213.978,91.2623,2777,1460,0.990351,0,2,1443758,1440981,2777
9691781,214.231,79.8546,2993,5840,0.976558,0,2,1443974,1440981,2993
9691781,241.452,69.8727,3425,5840,0.955738,0,2,1444406,1440981,3425
9707841,236.77,407.764,856,18961,0.935021,0,2,1444610,1443754,856
9707841,226.674,356.793,1012,18961,0.914393,0,2,1444766,1443754,1012
9709301,244.34,368.194,932,18961,0.891344,0,2,1445134,1444202,932
9712221,239.797,350.17,916,18727,0.866176,0,2,1445342,1444426,916
9713681,261.823,362.399,884,18493,0.841654,0,2,1445758,1444874,884
9716601,253.595,345.099,856,18246,0.822697,0,2,1445954,1445098,856
9718061,269.395,357.961,788,17974,0.81861,0,2,1446334,1445546,788
9719521,268.721,341.216,828,17636,0.825034,0,2,1446598,1445770,828
9720981,263.631,326.564,832,17402,0.830655,0,2,1446826,1445994,832
9732661,222.023,107.989,2308,10220,0.962635,0,2,1449914,1447606,2308
9745801,222.658,117.631,2562,1460,0.992988,0,2,1453022,1450460,2562
9782301,201.309,127.04,2304,5840,0.982251,0,2,1458326,1456022,2304
9782301,206.145,111.16,2544,5840,0.95322,0,2,1458566,1456022,2544
9782301,217.877,97.2648,2844,1460,0.922817,0,2,1458866,1456022,2844
9782301,217.643,85.1067,3060,20440,0.903715,0,2,1459082,1456022,3060
9782301,215.937,74.4684,3264,21900,0.877001,0,2,1459286,1456022,3264
9798361,215.945,412.41,702,23360,0.861126,0,2,1459502,1458800,702
9798361,202.452,360.859,810,24820,0.849735,0,2,1459610,1458800,810
9798361,196.645,315.751,966,24820,0.844768,0,2,1459766,1458800,966
9801281,203.565,328.782,798,24820,0.862922,0,2,1460018,1459220,798
9811501,270.467,301.595,1170,28156,0.913397,0,2,1461454,1460284,1170
9830481,201.467,82.0657,2795,5840,0.991487,0,2,1465994,1463199,2795
9869901,178.797,311.003,1248,14600,0.993486,0,2,1470506,1469258,1248
9869901,166.281,139.577,2244,5840,0.994576,0,2,1471502,1469258,2244
9869901,167.996,122.13,2424,5840,0.964004,0,2,1471682,1469258,2424
9869901,173.997,106.863,2640,18980,0.916004,0,2,1471898,1469258,2640
9869901,176.247,93.5055,2832,20440,0.882753,0,2,1472090,1469258,2832
9888881,206.716,410.192,625,21900,0.876159,0,2,1472510,1471885,625
9893261,188.377,367.543,616,23360,0.867889,0,2,1472570,1471954,616
9893261,170.83,321.6,664,24820,0.855653,0,2,1472618,1471954,664
9896181,167.476,295.15,698,24820,0.852446,0,2,1472762,1472064,698
9899101,158.541,272.007,684,27740,0.852141,0,2,1472858,1472174,684
9902021,156.724,251.756,718,30660,0.864373,0,2,1473002,1472284,718
9904941,152.133,234.036,728,33580,0.872576,0,2,1473122,1472394,728
9926841,172.819,45.8864,2668,1460,0.980586,0,2,1475942,1473274,2668
9932681,203.838,255.89,1290,13140,0.988787,0,2,1477346,1476056,1290
9967721,224.898,258.029,1172,17520,0.995771,0,2,1480498,1479326,1172
9967721,201.785,225.775,1212,18980,0.99255,0,2,1480538,1479326,1212
9980861,308.165,464.223,630,32120,0.953299,0,2,1485542,1484912,630
9991081,292.145,427.07,643,20749,0.907886,0,2,1485722,1485079,643
9994001,275.126,394.561,632,20749,0.865651,0,2,1485878,1485246,632
9995461,258.736,366.116,609,20749,0.841194,0,2,1486022,1485413,609
10004221,245.894,341.227,598,20749,0.834795,0,2,1486178,1485580,598
10007141,257.157,319.448,767,20749,0.849196,0,2,1486514,1485747,767
10015901,234.36,110.46,2418,8760,0.968375,0,2,1489334,1486916,2418
10026121,251.394,353.418,1248,10220,0.977057,0,2,1490942,1489694,1248
10065541,252.339,320.167,1148,11680,0.997936,0,2,1496914,1495766,1148
10067001,218.537,153.691,2112,4380,0.989074,0,2,1498034,1495922,2112
10069921,234.72,348.98,744,4380,0.955439,0,2,1498382,1497638,744
10071381,232.38,324.857,804,14600,0.937259,0,2,1498598,1497794,804
10078681,233.333,314.25,804,14600,0.923852,0,2,1498838,1498034,804
10081601,255.166,318.469,864,26840,0.90712,0,2,1499246,1498382,864
10084521,254.77,309.66,868,26522,0.88748,0,2,1499498,1498630,868
10087441,252.924,301.953,860,26260,0.877795,0,2,1499738,1498878,860
10090361,248.309,295.209,828,26016,0.881821,0,2,1499954,1499126,828
10093281,245.77,289.308,808,25717,0.895343,0,2,1500182,1499374,808
10126861,232.082,22.3224,5103,18980,0.994616,0,2,1508978,1503875,5103
10144381,243.673,363.242,2073,5840,0.988584,0,2,1511522,1509449,2073
10144381,243.214,317.837,2313,5840,0.967511,0,2,1511762,1509449,2313
10163361,322.312,583.357,747,1460,0.917822,0,2,1512638,1511891,747
10176501,354.023,603.812,576,23360,0.904344,0,2,1513214,1512638,576
10179421,330.77,537.836,668,24820,0.905051,0,2,1513382,1512714,668
10182341,313.424,489.606,708,27740,0.91067,0,2,1513574,1512866,708
10199861,166.831,69.0035,2538,5840,0.983271,0,2,1516286,1513748,2538
10226141,213.294,220.786,1218,16060,0.983431,0,2,1517902,1516684,1218
10226141,191.632,193.188,1258,17520,0.978002,0,2,1517942,1516684,1258
10250961,196.473,239.671,1042,16060,0.996153,0,2,1521038,1519996,1042
10250961,205.806,94.1178,2530,5840,0.997239,0,2,1522526,1519996,2530
10271401,189.435,222.672,1284,5840,0.995524,0,2,1524278,1522994,1284
10272861,266.213,383.684,682,1460,0.956741,0,2,1525946,1525264,682
10274321,312.436,420.974,636,24715,0.923398,0,2,1526582,1525946,636
10284541,285.382,385.102,598,24715,0.891724,0,2,1526678,1526080,598
10287461,284.209,353.714,740,24715,0.879008,0,2,1526954,1526214,740
10290381,286.183,343,772,27222,0.870382,0,2,1527254,1526482,772
10293301,286.41,333.625,792,26961,0.875334,0,2,1527542,1526750,792
10296221,289.609,325.422,836,26787,0.889668,0,2,1527854,1527018,836
10326881,220.977,68.8641,3836,11680,0.994712,0,2,1535282,1531446,3836
10326881,214.448,9.29209,7100,8760,0.990537,0,2,1538546,1531446,7100
10341481,217.642,792.131,1068,10220,0.979219,0,2,1538786,1537718,1068
10357541,220.437,711.114,1164,11680,0.955567,0,2,1539026,1537862,1164
10357541,200.382,622.225,1224,13140,0.932371,0,2,1539086,1537862,1224
10357541,178.334,544.447,1248,14600,0.909575,0,2,1539110,1537862,1248
10357541,177.043,476.391,1416,14600,0.882128,0,2,1539278,1537862,1416
10357541,171.412,416.842,1548,14600,0.853112,0,2,1539410,1537862,1548
10357541,173.986,364.737,1740,16060,0.817723,0,2,1539602,1537862,1740
10357541,158.238,319.145,1788,17520,0.786758,0,2,1539650,1537862,1788
10357541,150.458,279.252,1884,18980,0.752163,0,2,1539746,1537862,1884
10357541,146.651,244.345,2004,20440,0.721892,0,2,1539866,1537862,2004
10357541,140.319,213.802,2100,21900,0.687906,0,2,1539962,1537862,2100
10357541,134.779,187.077,2196,23360,0.653168,0,2,1540058,1537862,2196
10357541,128.432,163.692,2280,24820,0.622772,0,2,1540142,1537862,2280
10357541,127.378,143.231,2400,26280,0.596175,0,2,1540262,1537862,2400
10357541,120.456,125.327,2472,27740,0.570403,0,2,1540334,1537862,2472
10357541,117.399,109.661,2568,29200,0.550353,0,2,1540430,1537862,2568
10357541,114.724,95.9534,2664,29539,0.530309,0,2,1540526,1537862,2664
10357541,115.383,83.9592,2784,29539,0.51527,0,2,1540646,1537862,2784
10357541,112.96,73.4643,2880,29539,0.507111,0,2,1540742,1537862,2880
10357541,115.34,64.2813,3012,1460,0.504973,0,2,1540874,1537862,3012
10357541,115.923,56.2461,3132,5840,0.503101,0,2,1540994,1537862,3132
10357541,117.933,49.2153,3264,7300,0.506463,0,2,1541126,1537862,3264
10357541,119.691,43.0634,3396,8760,0.514405,0,2,1541258,1537862,3396
10398421,113.73,410.68,484,10220,0.518855,0,2,1541330,1540846,484
10398421,117.513,359.345,628,11680,0.532748,0,2,1541474,1540846,628
10398421,120.824,314.427,772,11680,0.547404,0,2,1541618,1540846,772
10398421,122.221,275.124,904,11680,0.570229,0,2,1541750,1540846,904
10401341,144.444,300.733,724,11680,0.6027,0,2,1542050,1541326,724
10404261,157.888,293.142,736,14600,0.626113,0,2,1542302,1541566,736
10407181,174.152,286.499,784,17520,0.661599,0,2,1542590,1541806,784
10437841,203.34,293.04,1068,13140,0.986989,0,2,1548374,1547306,1068
10465581,230.456,127.389,2709,1460,0.9866,0,2,1552814,1550105,2709
10465581,231.649,111.466,2949,5840,0.973275,0,2,1553054,1550105,2949
10465581,232.693,97.5326,3189,7300,0.950365,0,2,1553294,1550105,3189
10465581,233.606,85.341,3429,5840,0.91282,0,2,1553534,1550105,3429
10471421,216.406,389.423,1007,5840,0.874967,0,2,1553630,1552623,1007
10472881,193.855,364.62,852,5840,0.836846,0,2,1553666,1552814,852
10486021,178.623,332.918,813,5840,0.80099,0,2,1553738,1552925,813
10486021,172.795,291.303,945,5840,0.759617,0,2,1553870,1552925,945
10486021,158.696,254.89,1005,5840,0.720915,0,2,1553930,1552925,1005
10488941,177.859,315.654,576,5840,0.67455,0,2,1554242,1553666,576
10491861,175.126,290.072,621,23360,0.626481,0,1,1554398,1553777,621
10493321,188.736,281.563,683,26280,0.576921,0,1,1554682,1553999,683
10496241,171.644,276.743,492,27740,0.528556,0,1,1554734,1554242,492
10499161,169.688,264.15,472,30660,0.493737,0,1,1554890,1554418,472
10502081,169.477,253.131,464,30501,0.46327,0,1,1555058,1554594,464
10505001,169.293,243.49,456,33421,0.444111,0,2,1555226,1554770,456
10507921,173.631,235.054,484,32344,0.437347,0,2,1555430,1554946,484
10510841,175.927,227.672,500,31304,0.443929,0,2,1555622,1555122,500
10513761,174.936,217.713,520,30452,0.459688,0,2,1555790,1555270,520
10516681,174.069,208.999,540,29790,0.485977,0,2,1555958,1555418,540
10519601,177.811,201.374,596,29285,0.52148,0,2,1556162,1555566,596
10522521,179.584,194.702,640,29064,0.575045,0,2,1556354,1555714,640
10537121,207.743,159.475,1192,29319,0.808032,0,2,1557718,1556526,1192
10553541,211.581,408.246,1238,16060,0.951334,0,2,1560773,1559535,1238
10553541,209.298,160.317,2690,14600,0.972139,0,2,1562225,1559535,2690
10553541,228.421,14.4918,7142,5840,0.994982,0,2,1566677,1559535,7142
10565221,229.635,847.22,921,8760,0.994908,0,2,1567145,1566224,921
10566681,218.93,767.943,852,10220,0.979294,0,2,1567289,1566437,852
10568141,212.564,686.2,906,11680,0.940632,0,2,1567457,1566551,906
10592961,196.494,614.675,876,13140,0.904303,0,2,1567541,1566665,876
10595881,185.432,552.091,870,14600,0.861265,0,2,1567649,1566779,870
10597341,183.253,500.329,900,16060,0.814857,0,2,1567817,1566917,900
10600261,179.846,466.288,828,17520,0.76675,0,2,1567973,1567145,828
10603181,170.866,422.252,822,18980,0.722156,0,2,1568081,1567259,822
10606101,161.507,397.971,690,21900,0.675637,0,2,1568177,1567487,690
10609021,162.319,376.724,630,24820,0.619932,0,1,1568345,1567715,630
10611941,164.529,358.134,582,25408,0.561191,0,1,1568525,1567943,582
10614861,166.463,341.867,534,24793,0.497292,0,1,1568705,1568171,534
10617781,159.155,327.634,414,24102,0.44138,0,1,1568813,1568399,414
10620701,161.761,315.179,366,24516,0.387458,0,1,1568993,1568627,366
10623621,170.291,304.282,368,23414,0.342776,0,1,1569223,1568855,368
10626541,178.004,292.747,388,22450,0.303679,0,1,1569455,1569067,388
10629461,176.629,282.653,343,21679,0.274469,0,1,1569622,1569279,343
10632381,182.55,273.822,355,20852,0.25141,0,1,1569846,1569491,355
10635301,192.731,266.094,407,20164,0.231234,0,1,1570110,1569703,407
10638221,197.14,259.332,423,19750,0.23108,0,1,1570338,1569915,423
10641141,203.997,253.416,463,19447,0.238445,0,1,1570590,1570127,463
10644061,209.998,248.239,503,19310,0.259889,0,2,1570842,1570339,503
10646981,215.248,243.709,543,22230,0.286153,0,2,1571094,1570551,543
10649901,221.342,239.745,595,22230,0.321634,0,2,1571358,1570763,595
10652821,219.174,233.527,609,22230,0.37768,0,2,1571562,1570953,609
10655741,218.778,225.336,657,22230,0.44172,0,2,1571778,1571121,657
10658661,218.43,218.169,705,22230,0.505255,0,2,1571994,1571289,705
10673261,209.801,70.6914,2517,10220,0.902806,0,2,1574730,1572213,2517
10673261,213.576,61.855,2757,10220,0.893705,0,2,1574970,1572213,2757
10673261,215.379,54.1231,2985,11680,0.905742,0,2,1575198,1572213,2985
10677641,228.695,175.778,2301,17520,0.968303,0,2,1577826,1575525,2301
10677641,244.527,27.1068,5469,5840,0.988862,0,2,1580994,1575525,5469
10705381,457.966,889.254,717,18447,0.965222,0,2,1583190,1582473,717
10708301,424.72,805.097,693,15558,0.95082,0,2,1583382,1582689,693
10709761,398.63,731.46,693,15558,0.945717,0,2,1583598,1582905,693
10725821,378.802,667.027,717,15558,0.941253,0,2,1583838,1583121,717
10744801,238.597,37.3261,4956,14600,0.980431,0,2,1591530,1586574,4956
10744801,220.572,5.75606,8016,5840,0.976982,0,2,1594590,1586574,8016
10744801,221.5,5.03655,8244,5840,0.953609,0,2,1594818,1586574,8244
10792981,425.628,711.947,996,14600,0.975296,0,2,1602606,1601610,996
10792981,284.584,244.631,2700,21900,0.985261,0,2,1604310,1601610,2700
10832401,228.765,213.126,2414,18980,0.970792,0,2,1609782,1607368,2414
10832401,230.169,186.485,2654,20440,0.930693,0,2,1610022,1607368,2654
10832401,228.398,163.175,2870,21900,0.905607,0,2,1610238,1607368,2870
10832401,237.348,142.778,3170,1460,0.886156,0,2,1610538,1607368,3170
10832401,218.18,124.931,3254,5840,0.869136,0,2,1610622,1607368,3254
10832401,202.907,109.314,3350,7300,0.854244,0,2,1610718,1607368,3350
10832401,191.044,95.65,3458,5840,0.836214,0,2,1610826,1607368,3458
10832401,177.663,83.6937,3542,5840,0.817937,0,2,1610910,1607368,3542
10832401,165.955,73.232,3626,5840,0.806945,0,2,1610994,1607368,3626
10835321,157.211,443.578,686,5840,0.797327,0,2,1611090,1610404,686
10836781,154.06,404.881,684,5840,0.788911,0,2,1611222,1610538,684
10839701,143.802,363.271,684,5840,0.781547,0,2,1611294,1610610,684
10855761,137.827,326.862,708,5840,0.785104,0,2,1611390,1610682,708
10858681,167.099,337.004,672,5840,0.803216,0,2,1611762,1611090,672
10879121,209.009,101.352,2484,20440,0.936614,0,2,1614462,1611978,2484
10879121,212.883,88.683,2724,21900,0.932038,0,2,1614702,1611978,2724
10883501,207.168,127.222,2585,21900,0.973022,0,2,1617522,1614937,2585
10896641,213.308,322.303,1284,13140,0.984406,0,2,1619046,1617762,1284
10934601,232.688,354.804,985,13140,0.993502,0,2,1622106,1621121,985
10934601,232.335,207.98,1914,5840,0.994941,0,2,1623035,1621121,1914
10934601,224.929,159.234,2315,5840,0.982377,0,2,1623436,1621121,2315
10934601,223.813,139.33,2531,5840,0.963329,0,2,1623652,1621121,2531
10934601,293.336,121.914,3311,1460,0.966663,0,2,1624432,1621121,3311
10953581,335.481,433.891,1044,18717,0.967667,0,2,1625688,1624644,1044
10955041,322.046,406.155,1060,18717,0.964209,0,2,1625916,1624856,1060
10956501,308.79,381.886,1064,18717,0.966183,0,2,1626132,1625068,1064
10966721,309.408,358.373,1006,18717,0.965177,0,2,1627346,1626340,1006
10974021,282.877,302.61,1050,18717,0.974639,0,2,1628662,1627612,1050
10976941,272.017,291.284,1034,18717,0.971559,0,2,1628858,1627824,1034
10978401,293.265,307.873,1052,18717,0.971364,0,2,1629300,1628248,1052
10981321,281.107,295.889,1036,18717,0.972444,0,2,1629496,1628460,1036
10982781,294.969,311.903,1004,18247,0.972138,0,2,1629888,1628884,1004
10984241,286.598,299.415,1020,19707,0.965621,0,2,1630116,1629096,1020
10985701,276.273,288.488,1012,21167,0.968668,0,2,1630320,1629308,1012
10986561,272.114,278.927,1043,21167,0.960085,0,2,1630563,1629520,1043
10988021,1603.47,1684.31,444,21167,0.843824,0,1,1641486,1641042,444
10989481,1429.17,1501.15,434,20607,0.739596,0,1,1641695,1641261,434
10990941,1279.64,1340.88,448,19741,0.655897,0,1,1641928,1641480,448
10993861,1145.06,1200.64,432,19009,0.60516,0,1,1642131,1641699,432
10995321,1056.93,1094.31,522,18343,0.590765,0,2,1642571,1642049,522
10996781,953.315,979.399,575,17903,0.600669,0,2,1642799,1642224,575
10998241,865.65,878.849,652,17610,0.636835,0,2,1643051,1642399,652
11008461,360.449,231.526,2215,7300,0.901852,0,2,1645839,1643624,2215
11008461,343.893,202.586,2443,8760,0.910371,0,2,1646067,1643624,2443
11008461,310.763,103.908,3847,8760,0.952778,0,2,1647471,1643624,3847
11008461,274.392,23.9187,6631,1460,0.98538,0,2,1650255,1643624,6631
11043501,271.562,702.862,921,10220,0.982501,0,2,1651611,1650690,921
11044961,292.415,432.521,1996,5840,0.988493,0,2,1652931,1650935,1996
11044961,285.863,378.456,2236,7300,0.974931,0,2,1653171,1650935,2236
11053721,280.13,543.149,780,5840,0.964315,0,2,1653411,1652631,780
11053721,291.614,475.255,1152,5840,0.952525,0,2,1653783,1652631,1152
11053721,286.662,415.848,1404,5840,0.92221,0,2,1654035,1652631,1404
11053721,276.329,363.867,1608,14956,0.895683,0,2,1654239,1652631,1608
11053721,279.288,318.384,1908,14956,0.874973,0,2,1654539,1652631,1908
11053721,263.877,278.586,2064,15784,0.861851,0,2,1654695,1652631,2064
11062481,257.893,449.888,631,13571,0.86037,0,2,1654911,1654280,631
11063941,283.656,424.277,850,13950,0.869074,0,2,1655375,1654525,850
11072701,233.013,144.426,2239,10220,0.972379,0,2,1658247,1656008,2239
11072701,232.386,126.373,2467,11680,0.967082,0,2,1658475,1656008,2467
11101901,248.832,178.379,2020,7300,0.987849,0,2,1662783,1660763,2020
11109201,241.916,230.118,1632,8760,0.992047,0,2,1664187,1662555,1632
11109201,229.824,90.3665,3180,8760,0.986877,0,2,1665735,1662555,3180
11109201,231.096,79.0707,3420,5840,0.959767,0,2,1665975,1662555,3420
11109201,232.209,69.1868,3660,5840,0.932296,0,2,1666215,1662555,3660
11109201,237.683,60.5385,3936,5840,0.909509,0,2,1666491,1662555,3936
11123801,473.473,724.596,687,1460,0.894571,0,2,1668615,1667928,687
11155921,286.657,289.66,1075,17967,0.993164,0,2,1675218,1674143,1075
11164681,260.253,255.122,1117,18791,0.991932,0,2,1676622,1675505,1117
11177821,229.007,125.236,2116,8760,0.997328,0,2,1679526,1677410,2116
11177821,228.881,109.582,2344,8760,0.995162,0,2,1679754,1677410,2344
11186581,231.951,361.36,959,8760,0.994664,0,2,1680746,1679787,959
11189501,229.957,342.065,968,10220,0.981581,0,2,1680962,1679994,968
11195341,220.712,324.307,924,11680,0.967633,0,2,1681118,1680194,924
11195341,211.123,283.768,1068,13140,0.960429,0,2,1681262,1680194,1068
11195341,199.733,248.297,1188,13140,0.954126,0,2,1681382,1680194,1188
11198261,224.266,292.26,984,13140,0.95111,0,2,1681778,1680794,984
11201181,241.233,305.728,944,16060,0.953471,0,2,1682138,1681194,944
11237681,250.966,290.016,1020,8760,0.989362,0,2,1688162,1687142,1020
11237681,236.016,113.888,2592,1460,0.994573,0,2,1689734,1687142,2592
11255201,250.816,195.23,2013,7300,0.993572,0,2,1692278,1690265,2013
11255201,249.464,170.826,2253,7300,0.971876,0,2,1692518,1690265,2253
11255201,246.781,149.473,2481,8760,0.967891,0,2,1692746,1690265,2481
11271261,210.638,263.38,1054,11680,0.984891,0,2,1694054,1693000,1054
11288781,252.624,139.312,2250,7300,0.994466,0,2,1698302,1696052,2250
11297541,251.046,335.648,780,1460,0.985158,0,2,1698542,1697762,780
11312141,268.431,272.623,1141,18980,0.992833,0,2,1701490,1700349,1141
11328201,212.512,274.385,1372,11680,0.997487,0,2,1704086,1702714,1372
11328201,215.948,240.087,1612,11680,0.986551,0,2,1704326,1702714,1612
11328201,231.448,107.75,3082,8760,0.982714,0,2,1705796,1702714,3082
11328201,229.517,94.2811,3298,10220,0.971125,0,2,1706012,1702714,3298
11328201,226.327,82.496,3502,10220,0.963484,0,2,1706216,1702714,3502
11328201,223.536,72.184,3706,5840,0.941799,0,2,1706420,1702714,3706
11328201,221.094,63.161,3910,5840,0.917824,0,2,1706624,1702714,3910
11328201,218.958,55.2658,4114,5840,0.889346,0,2,1706828,1702714,4114
11341341,335.588,632.358,594,1460,0.839428,0,2,1707980,1707386,594
11342801,384.639,627.563,728,16060,0.805749,0,2,1708708,1707980,728
11344261,377.059,588.118,740,17462,0.773781,0,2,1709032,1708292,740
11345721,373.427,553.603,776,17116,0.748308,0,2,1709380,1708604,776
11347181,364.249,523.403,764,16854,0.731019,0,2,1709680,1708916,764
11348641,351.718,489.102,779,16611,0.725892,0,2,1709944,1709165,779
11350101,339.253,459.089,782,16414,0.733906,0,2,1710196,1709414,782
11351561,331.346,432.828,809,16246,0.755917,0,2,1710472,1709663,809
11353021,325.928,409.85,848,16124,0.785178,0,2,1710760,1709912,848
11367621,275.174,291.316,1010,17548,0.942235,0,2,1713412,1712402,1010
11377841,260.32,250.72,1151,17548,0.968566,0,2,1715152,1714001,1151
11401201,250.181,112.11,2743,1460,0.996225,0,2,1721204,1718461,2743
11401201,266.908,98.0964,3127,5840,0.990447,0,2,1721588,1718461,3127
11401201,265.045,85.8343,3379,7300,0.972891,0,2,1721840,1718461,3379
11415801,248.414,398.98,920,8760,0.950029,0,2,1721972,1721052,920
11415801,239.862,349.108,1100,10220,0.922526,0,2,1722152,1721052,1100
11415801,229.38,305.469,1256,10220,0.89346,0,2,1722308,1721052,1256
11418721,244.207,349.785,944,10220,0.860528,0,2,1722656,1721712,944
11421641,258.681,361.062,864,13140,0.821712,0,2,1723016,1722152,864
11423101,272.346,370.929,792,16060,0.785248,0,2,1723384,1722592,792
11426021,262.803,352.063,768,17520,0.763342,0,2,1723580,1722812,768
11428941,274.952,357.555,732,20440,0.749174,0,2,1723940,1723208,732
11431861,288.583,356.861,764,22879,0.751777,0,2,1724324,1723560,764
11443541,241.327,110.462,2570,8760,0.945003,0,2,1727540,1724970,2570
11480041,227.415,336.893,1013,13140,0.98815,0,2,1731932,1730919,1013
11481501,234.962,152.941,2349,7300,0.990347,0,2,1733636,1731287,2349
11481501,254.212,78.4448,3741,8760,0.992549,0,2,1735028,1731287,3741
11481501,257.208,52.5519,4521,5840,0.976258,0,2,1735808,1731287,4521
11481501,258.057,45.9829,4785,5840,0.926726,0,2,1736072,1731287,4785
11501941,384.8,752.61,358,1460,0.854635,0,2,1737344,1736986,358
11503401,417.2,703.284,644,16641,0.831556,0,2,1737988,1737344,644
11504861,404.05,645.873,712,16140,0.841361,0,2,1738300,1737588,712
11513621,264.11,183.192,2315,7300,0.961797,0,2,1741220,1738905,2315
11523841,261.096,362.668,936,8760,0.964073,0,2,1741460,1740524,936
11563261,226.276,158.476,1976,8760,0.990812,0,2,1749080,1747104,1976
11563261,245.991,138.666,2360,5840,0.94821,0,2,1749464,1747104,2360
11569101,240.742,338.333,828,5840,0.899684,0,2,1749668,1748840,828
11569101,282.65,296.041,1404,5840,0.845973,0,2,1750244,1748840,1404
11572021,311.818,434.536,516,19574,0.798977,0,2,1750760,1750244,516
11572021,298.341,380.219,720,19574,0.770355,0,2,1750964,1750244,720
11572021,291.048,332.692,960,18114,0.74531,0,2,1751204,1750244,960
11572021,263.667,291.105,1032,1460,0.725897,0,2,1751276,1750244,1032
11572021,250.209,254.717,1188,5840,0.71391,0,2,1751432,1750244,1188
11573481,251.933,332.878,572,7300,0.710921,0,2,1751696,1751124,572
11573481,232.441,291.268,668,8760,0.713306,0,2,1751792,1751124,668
11583701,236.386,296.234,601,8760,0.720393,0,2,1752056,1751455,601
11585161,260.338,281.205,853,10220,0.749093,0,2,1752484,1751631,853
11596841,216.095,97.6163,2286,7300,0.957558,0,2,1755380,1753094,2286
11626041,229.583,156.109,1980,8760,0.98368,0,2,1759916,1757936,1980
11633341,226.965,74.1402,3408,10220,0.986233,0,2,1763084,1759676,3408
11633341,243.595,64.8727,3768,10220,0.962954,0,2,1763444,1759676,3768
11633341,232.645,56.7636,3924,11680,0.946335,0,2,1763600,1759676,3924
11633341,235.065,49.6681,4176,5840,0.906793,0,2,1763852,1759676,4176
11633341,249.182,43.4596,4524,5840,0.842194,0,2,1764200,1759676,4524
11655241,323.034,660.902,381,1460,0.76817,0,1,1765040,1764659,381
11656701,355.655,625.914,584,13140,0.708398,0,1,1765624,1765040,584
11658161,336.698,573.925,578,13581,0.663599,0,2,1765828,1765250,578
11659621,321.611,528.434,584,13121,0.629399,0,2,1766044,1765460,584
11661081,311.409,488.63,614,14581,0.596974,0,2,1766284,1765670,614
11662541,311.483,468.801,596,15541,0.586102,0,2,1766596,1766000,596
11664001,328.048,451.451,710,15241,0.589089,0,2,1767040,1766330,710
11665461,321.542,427.145,729,15105,0.601703,0,2,1767316,1766587,729
11666921,318.849,405.877,772,15005,0.63149,0,2,1767616,1766844,772
11668381,319.493,387.267,839,14969,0.676304,0,2,1767940,1767101,839
11682981,277.226,282.994,1073,15726,0.892344,0,2,1770664,1769591,1073
11684441,271.073,277.245,1064,15795,0.894551,0,2,1770892,1769828,1064
11718021,236.899,320.499,1250,10220,0.992975,0,2,1777016,1775766,1250
11723861,275.26,338.543,1133,5840,0.962132,0,2,1778308,1777175,1133
11725321,270.853,323.6,1154,5840,0.923115,0,2,1778548,1777394,1154
11726781,263.996,310.525,1151,5840,0.886476,0,2,1778764,1777613,1151
11728241,256.497,300.584,1124,5840,0.856916,0,2,1778968,1777844,1124
11731161,254.935,321.011,904,11680,0.828552,0,2,1779212,1778308,904
11732621,270.568,338.26,825,14600,0.823733,0,2,1779592,1778767,825
11734081,262.247,322.977,813,16060,0.824516,0,2,1779796,1778983,813
11735541,256.466,309.605,813,17520,0.822702,0,2,1780012,1779199,813
11737001,254.408,297.904,837,18384,0.833614,0,2,1780252,1779415,837
11738461,258.607,287.666,909,18127,0.853162,0,2,1780540,1779631,909
11755981,243.66,230.435,1209,17938,0.967924,0,2,1783432,1782223,1209
11757441,241.703,228.63,1221,17938,0.961934,0,2,1783660,1782439,1221
11757441,238.093,8.11588,6853,8760,0.983649,0,2,1789292,1782439,6853
11757441,238.331,7.10139,7093,10220,0.974443,0,2,1789532,1782439,7093
11757441,248.549,3.18707,8629,16060,0.98478,0,2,1791068,1782439,8629
11757441,245.98,2.78869,8857,5840,0.980433,0,2,1791296,1782439,8857
11757441,242.233,2.4401,9073,5840,0.974128,0,2,1791512,1782439,9073
11757441,240.454,2.13509,9301,5840,0.961112,0,2,1791740,1782439,9301
161701,223.517,148.783,2856,18980,0.993201,0,2,52190,49334,2856
209881,193.393,312.124,951,14600,0.99738,0,2,54677,53726,951
214261,169.907,184.311,1352,21900,0.993656,0,2,55366,54014,1352
214261,175.669,161.272,1568,23360,0.991949,0,2,55582,54014,1568
214261,124.477,48.4878,2401,30875,0.991329,0,2,56415,54014,2401
214261,124.293,42.4268,2524,30875,0.977413,0,2,56538,54014,2524
214261,110.256,37.1235,2536,5840,0.965237,0,2,56550,54014,2536
214261,106.974,32.483,2620,5840,0.950832,0,2,56634,54014,2620
214261,110.102,28.4227,2752,5840,0.920728,0,2,56766,54014,2752
218641,229.964,453.62,391,30875,0.825637,0,1,57835,57444,391
220101,210.219,405.542,394,27533,0.741182,0,1,57907,57513,394
223021,191.442,363.475,385,27533,0.662285,0,1,57967,57582,385
224481,176.511,326.665,388,27533,0.583249,0,1,58039,57651,388
266821,160.447,294.457,367,27533,0.510343,0,1,58087,57720,367
267281,171.892,266.275,550,27533,0.4478,0,1,58339,57789,550
270201,700.405,808.741,344,27533,0.398075,0,1,62739,62395,344
273121,642.479,732.648,381,28977,0.352066,0,1,62976,62595,381
276041,581.545,666.067,336,27820,0.314307,0,1,63131,62795,336
278961,531.476,602.809,357,26633,0.278769,0,1,63312,62955,357
281881,480.667,547.458,322,25678,0.257673,0,1,63437,63115,322
284801,441.709,499.025,331,24723,0.259214,0,1,63606,63275,331
287721,411.995,456.647,375,23912,0.280562,0,2,63810,63435,375
290641,391.996,419.566,467,23362,0.326742,0,2,64062,63595,467
293561,377.496,387.121,583,23218,0.409649,0,2,64338,63755,583
305241,249.35,91.5691,2791,11680,0.880956,0,2,67266,64475,2791
311081,291.814,24.9773,6094,12027,0.993015,0,2,73950,67856,6094
311081,357.337,21.8552,6910,12027,0.975138,0,2,74766,67856,6910
330061,440.17,924.123,690,18314,0.951996,0,2,75786,75096,690
341741,410.649,834.858,684,15114,0.936746,0,2,75990,75306,684
362181,383.318,756.751,666,15114,0.925903,0,2,76182,75516,666
363641,387.403,688.407,872,15114,0.926415,0,2,76598,75726,872
384081,239.532,101.205,3554,8760,0.985078,0,2,83874,80320,3554
384081,239.591,88.5546,3794,10220,0.981943,0,2,84114,80320,3794
384081,244.015,59.3247,4550,13140,0.986653,0,2,84870,80320,4550
384081,239.652,34.775,5491,18980,0.990926,0,2,85811,80320,5491
384081,239.696,30.4282,5731,19209,0.988311,0,2,86051,80320,5731
384081,221.824,17.8364,6523,20669,0.990648,0,2,86843,80320,6523
384081,219.596,15.6069,6727,22129,0.981817,0,2,87047,80320,6727
417661,242.022,800.656,830,23282,0.95034,0,2,87446,86616,830
420581,229.769,719.574,822,23282,0.922797,0,2,87590,86768,822
422041,220.548,648.627,826,23282,0.888698,0,2,87746,86920,826
432261,203.479,586.549,758,23282,0.86136,0,2,87830,87072,758
435181,211.045,532.23,870,23282,0.82494,0,2,88094,87224,870
438101,210.789,503.701,775,23128,0.775573,0,2,88303,87528,775
441021,221.065,478.739,764,22763,0.717376,0,2,88596,87832,764
442001,229.932,456.896,752,22418,0.652704,0,1,88888,88136,752
444921,1678.44,1915.03,448,22072,0.602366,0,1,100706,100258,448
446381,1514.64,1713.66,512,21054,0.58582,0,2,101074,100562,512
447841,1353.81,1518.45,588,20304,0.583843,0,2,101302,100714,588
450761,1207.58,1347.64,620,19843,0.604613,0,2,101486,100866,620
462441,370.172,255.946,2396,10220,0.920277,0,2,104630,102234,2396
462441,353.901,223.952,2636,11680,0.913993,0,2,104870,102234,2636
485801,276.711,38.8885,5292,13140,0.994829,0,2,111074,105782,5292
485801,270.053,22.7957,6348,5840,0.990719,0,2,112130,105782,6348
485801,248.297,19.9462,6444,5840,0.988129,0,2,112226,105782,6444
485801,250.26,17.453,6708,18980,0.983363,0,2,112490,105782,6708
485801,253.477,15.2713,6984,18858,0.981692,0,2,112766,105782,6984
488721,283.293,844.362,828,18858,0.975231,0,2,113258,112430,828
532521,231.091,221.415,2070,8760,0.991885,0,2,116246,114176,2070
555881,229.813,255.404,1176,10220,0.988365,0,2,119210,118034,1176
566101,229.71,149.382,2304,14600,0.99283,0,2,123770,121466,2304
566101,230.997,130.709,2544,19111,0.979976,0,2,124010,121466,2544
566101,224.622,114.371,2724,20571,0.976229,0,2,124190,121466,2724
566101,211.544,100.074,2844,19911,0.97295,0,2,124310,121466,2844
566101,203.101,87.565,2988,19911,0.962582,0,2,124454,121466,2988
586541,218.214,389.494,809,19911,0.956009,0,2,124778,123969,809
586541,214.937,340.808,1001,19911,0.952758,0,2,124970,123969,1001
590921,212.07,345.707,813,19911,0.952413,0,2,125162,124349,813
593841,232.061,328.493,977,19911,0.952111,0,2,125534,124557,977
595301,256.553,339.432,989,19756,0.954348,0,2,125962,124973,989
596761,252.984,323.003,1009,19644,0.958804,0,2,126190,125181,1009
608441,226.54,151.562,1941,8760,0.986767,0,2,128702,126761,1941
608441,223.723,132.617,2145,8760,0.983421,0,2,128906,126761,2145
625961,207.651,245.684,1368,13140,0.991803,0,2,130490,129122,1368
625961,212.859,49.4849,3936,11680,0.989599,0,2,133058,129122,3936
625961,207.524,8.72122,6768,14600,0.986917,0,2,135890,129122,6768
625961,210.083,7.63107,6996,16060,0.984802,0,2,136118,129122,6996
625961,225.226,3.91404,8220,18198,0.983455,0,2,137342,129122,8220
625961,225.573,3.42479,8448,5840,0.955523,0,2,137570,129122,8448
625961,224.376,2.99669,8664,5840,0.924833,0,2,137786,129122,8664
665381,404.829,1234.87,474,18198,0.862979,0,2,139454,138980,474
668301,382.726,1109.01,474,18518,0.833856,0,2,139682,139208,474
669761,391.385,998.886,698,18518,0.833374,0,2,140134,139436,698
671221,382.962,902.526,794,17942,0.842952,0,2,140458,139664,794
688741,287.493,402.363,974,17301,0.961349,0,2,143374,142400,974
696041,275.852,317.432,1139,20221,0.975176,0,2,144679,143540,1139
698961,225.025,133.055,2223,7300,0.99022,0,2,146219,143996,2223
709181,225.397,310.298,900,8760,0.990193,0,2,146447,145547,900
723781,227.422,290.441,975,8760,0.995525,0,2,149195,148220,975
739841,206.236,314.656,1117,5840,0.984099,0,2,151679,150562,1117
739841,205.957,275.324,1321,5840,0.947336,0,2,151883,150562,1321
739841,204.212,240.909,1513,5840,0.915169,0,2,152075,150562,1513
742761,217.686,318.92,960,5840,0.862023,0,2,152387,151427,960
745681,218.975,326.305,810,16060,0.81052,0,2,152615,151805,810
748601,248.603,358.267,684,18980,0.750455,0,2,153071,152387,684
751521,259.528,360.734,642,19990,0.710398,0,2,153407,152765,642
752981,273.087,362.892,632,19358,0.685349,0,2,153775,153143,632
754441,265.951,341.155,659,18789,0.66843,0,2,153991,153332,659
755901,262.707,322.136,710,18342,0.666126,0,2,154231,153521,710
757361,255.369,305.494,725,18050,0.67911,0,2,154435,153710,725
758821,254.948,290.932,788,17819,0.705472,0,2,154687,153899,788
777801,223.513,33.8009,3995,10220,0.985745,0,2,160523,156528,3995
777801,240.045,17.3368,5243,16060,0.987689,0,2,161771,156528,5243
777801,240.04,15.1697,5483,17520,0.982978,0,2,162011,156528,5483
821601,258.737,426.419,1208,18980,0.985321,0,2,165091,163883,1208
821601,229.895,373.117,1236,5840,0.982156,0,2,165119,163883,1236
821601,226.457,249.959,1896,5840,0.969296,0,2,165779,163883,1896
821601,220.65,218.714,2076,5840,0.941884,0,2,165959,163883,2076
824521,250.068,401.375,852,4380,0.905399,0,2,166415,165563,852
827441,232.31,378.203,744,18980,0.863474,0,2,166523,165779,744
833281,218.271,353.428,684,18980,0.834289,0,2,166643,165959,684
836201,262.987,366.249,804,5840,0.821253,0,2,167219,166415,804
839121,275.114,365.468,804,8760,0.829847,0,2,167579,166775,804
849341,243.02,137.276,2232,8760,0.959478,0,2,170531,168299,2232
849341,241.142,120.117,2460,10220,0.953293,0,2,170759,168299,2460
849341,238.13,53.9079,3888,10220,0.970288,0,2,172187,168299,3888
849341,253.98,24.1936,5460,17520,0.982916,0,2,173759,168299,5460
875621,231.886,637.094,1246,11680,0.989541,0,2,175283,174037,1246
898981,223.871,244.452,1878,5840,0.980015,0,2,178835,176957,1878
898981,218.387,213.896,2058,5840,0.952513,0,2,179015,176957,2058
898981,218.089,187.159,2274,5840,0.905949,0,2,179231,176957,2274
898981,214.828,163.764,2466,5840,0.843955,0,2,179423,176957,2466
898981,247.974,143.293,2946,1460,0.752211,0,1,179903,176957,2946
900441,219.978,435.882,486,21900,0.679435,0,1,179927,179441,486
912121,226.98,439.147,300,23360,0.608255,0,1,180203,179903,300
916501,209.108,400.253,256,24820,0.545973,0,1,180287,180031,256
919421,205.469,366.222,308,26280,0.493977,0,1,180467,180159,308
922341,209.786,336.444,420,27740,0.45098,0,1,180707,180287,420
925261,219.562,326.388,452,27260,0.415857,0,1,180995,180543,452
928181,225.117,317.59,460,25823,0.390125,0,1,181259,180799,460
931101,229.977,309.891,468,24591,0.375109,0,1,181523,181055,468
934021,235.73,303.155,488,23541,0.374471,0,2,181799,181311,488
936941,246.764,297.26,556,22675,0.391412,0,2,182123,181567,556
939861,256.419,292.103,624,22104,0.418735,0,2,182447,181823,624
942781,263.366,287.59,680,17658,0.457643,0,2,182759,182079,680
945701,266.445,283.641,712,20491,0.501688,0,2,183047,182335,712
947161,283.64,285.186,820,20491,0.557727,0,2,183451,182631,820
958841,231.206,88.1918,2670,13140,0.920804,0,2,186407,183737,2670
961761,234.979,352.174,1252,11680,0.963207,0,2,187847,186595,1252
961761,225.307,92.6483,3514,8760,0.989071,0,2,190109,186595,3514
961761,207.644,81.0673,3598,10220,0.989187,0,2,190193,186595,3598
973441,183.188,410.434,894,11680,0.989289,0,2,190205,189311,894
999721,197.497,312.693,1203,16060,0.990324,0,2,190882,189679,1203
1012861,219.386,277.962,1115,27740,0.988787,0,2,192126,191011,1115
1014321,155.395,86.5352,2238,5840,0.986629,0,2,193318,191080,2238
1014321,161.47,75.7183,2442,5840,0.9583,0,2,193522,191080,2442
1017241,168.286,268.004,1044,30030,0.922263,0,2,193738,192694,1044
1017241,169.751,234.503,1224,31490,0.89323,0,2,193918,192694,1224
1017241,197.407,205.19,1615,32950,0.855326,0,2,194309,192694,1615
1018701,184.731,310.041,667,32950,0.82716,0,2,194405,193738,667
1020161,170.64,282.036,653,34410,0.802515,0,2,194477,193824,653
1024541,158.31,257.532,639,35870,0.783451,0,2,194549,193910,639
1028921,150.521,236.09,649,37330,0.766769,0,2,194645,193996,649
1030381,137.706,217.329,611,38790,0.749673,0,2,194693,194082,611
1040601,129.493,200.913,597,38817,0.732214,0,2,194765,194168,597
1043521,132.806,186.549,667,38817,0.726937,0,2,194921,194254,667
1046441,143.205,184.73,711,37533,0.72732,0,2,195137,194426,711
1049361,144.805,183.139,695,36587,0.735155,0,2,195293,194598,695
1052281,144.704,181.747,667,35708,0.749511,0,2,195437,194770,667
1055201,155.116,180.528,723,34795,0.779572,0,2,195665,194942,723
1104941,191.457,265.807,1284,13140,0.985043,0,2,202698,201414,1284
1104941,194.525,232.581,1500,14600,0.970663,0,2,202914,201414,1500
1104941,195.709,203.509,1704,16060,0.96808,0,2,203118,201414,1704
1104941,215.838,21.0242,5124,5840,0.987952,0,2,206538,201414,5124
1104941,209.859,18.3962,5292,23360,0.981958,0,2,206706,201414,5292
1104941,206.126,16.0967,5472,20137,0.970464,0,2,206886,201414,5472
1109321,240.361,654.96,825,20137,0.960406,0,2,207366,206541,825
1145821,228.315,594.84,795,20137,0.956605,0,2,207510,206715,795
1148741,238.776,542.235,933,20137,0.953279,0,2,207822,206889,933
1163341,233.624,165.493,2318,10220,0.975516,0,2,211086,208768,2318
1163341,232.921,144.806,2546,10220,0.973576,0,2,211314,208768,2546
1204221,217.602,133.473,2196,14600,0.990532,0,2,217200,215004,2196
1212981,213.128,165.305,1812,11680,0.994501,0,2,218460,216648,1812
1239261,222.312,114.424,2524,10220,0.992119,0,2,222876,220352,2524
1239261,223.023,100.121,2752,1460,0.989354,0,2,223104,220352,2752
1259701,205.123,125.718,2401,13140,0.997108,0,2,225912,223511,2401
1271381,233.921,356.294,1092,10220,0.988517,0,2,227244,226152,1092
1299121,174.673,102.795,2454,5840,0.989592,0,2,231597,229143,2454
1299121,181.339,89.946,2682,23360,0.988393,0,2,231825,229143,2682
1345841,147.069,242.086,1190,20440,0.998474,0,2,236301,235111,1190
1372121,185.309,273.757,1187,14600,0.997294,0,2,239098,237911,1187
1372121,177.317,94.0654,2591,1460,0.99782,0,2,240502,237911,2591
1372121,182.153,82.3072,2807,5840,0.991843,0,2,240718,237911,2807
1399861,190.918,99.1186,2396,26280,0.992492,0,2,243406,241010,2396
1399861,194.053,86.7288,2612,1460,0.978431,0,2,243622,241010,2612
1426141,203.272,118.256,2340,1460,0.98459,0,2,246598,244258,2340
1426141,203.363,103.474,2544,5840,0.972766,0,2,246802,244258,2544
1426141,200.443,90.5398,2724,7300,0.97492,0,2,246982,244258,2724
1461181,197.778,96.6706,2310,8760,0.992014,0,2,251170,248860,2310
1480161,201.52,229.446,1147,13140,0.994756,0,2,252814,251667,1147
1480161,195.249,90.1025,2467,1460,0.996691,0,2,254134,251667,2467
1497681,193.763,25.8263,4187,14600,0.987347,0,2,258454,254267,4187
1497681,198.042,22.598,4415,16060,0.982678,0,2,258682,254267,4415
1497681,195.763,8.87415,5783,21900,0.991948,0,2,260050,254267,5783
1497681,198.293,7.76488,5999,23360,0.972954,0,2,260266,254267,5999
1497681,215.923,0.470223,10295,1460,0.997112,0,2,264562,254267,10295
1564841,201.237,909.274,989,13140,0.996366,0,2,265918,264929,989
1564841,219.951,357.068,2609,5840,0.996073,0,2,267538,264929,2609
1583821,206.761,412.815,959,13140,0.995738,0,2,268714,267755,959
1583821,209.416,361.214,1187,14600,0.99252,0,2,268942,267755,1187
1583821,222.475,162.111,2579,5840,0.991643,0,2,270334,267755,2579
1599881,250.336,307.493,1263,13140,0.987499,0,2,271902,270639,1263
1599881,222.544,269.056,1291,14600,0.987812,0,2,271930,270639,1291
1599881,213.906,120.751,2527,11680,0.99328,0,2,273166,270639,2527
1602801,215.668,324.032,1008,1460,0.98287,0,2,273394,272386,1008
1620321,206.168,109.064,2355,8760,0.989858,0,2,276238,273883,2355
1655361,202.462,97.0938,2673,1460,0.994759,0,2,282022,279349,2673
1669961,215.517,120.825,2515,11680,0.988944,0,2,284746,282231,2515
1669961,217.077,105.722,2743,1460,0.989076,0,2,284974,282231,2743
1693321,159.421,82.3421,2489,1460,0.996513,0,2,287878,285389,2489
1693321,169.493,72.0494,2729,5840,0.993198,0,2,288118,285389,2729
1715221,173.096,233.773,1092,16060,0.987663,0,2,289414,288322,1092
1715221,176.959,204.552,1296,17520,0.979205,0,2,289618,288322,1296
1715221,204.042,41.2002,3744,11680,0.980812,0,2,292066,288322,3744
1715221,202.537,36.0502,3936,13140,0.95571,0,2,292258,288322,3936
1715221,204.22,31.5439,4152,14600,0.944996,0,2,292474,288322,4152
1715221,196.692,27.6009,4296,16060,0.948122,0,2,292618,288322,4296
1715221,200.606,24.1508,4524,17520,0.953357,0,2,292846,288322,4524
1718141,204.047,107.583,3729,13140,0.994087,0,2,297574,293845,3729
1718141,207.041,94.1347,3957,13140,0.992326,0,2,297802,293845,3957
1718141,208.161,82.3679,4173,13140,0.990786,0,2,298018,293845,4173
1788221,199.907,67.8528,3996,14600,0.99475,0,2,303517,299521,3996
1788221,223.237,15.6191,6612,11680,0.983791,0,2,306133,299521,6612
1788221,223.833,13.6667,6840,13140,0.960818,0,2,306361,299521,6840
1788221,222.853,11.9584,7056,14600,0.958215,0,2,306577,299521,7056
1788221,215.997,10.4636,7224,14600,0.957188,0,2,306745,299521,7224
1788221,214.497,9.15564,7428,16060,0.95629,0,2,306949,299521,7428
1788221,213.185,8.01118,7632,17520,0.958004,0,2,307153,299521,7632
1788221,199.003,2.40862,9324,30660,0.984873,0,2,308845,299521,9324
1788221,152.862,0.724172,10542,42173,0.987952,0,2,310063,299521,10542
1788221,160.754,0.63365,10758,43633,0.979458,0,2,310279,299521,10758
1798441,122.085,1418.46,1045,18980,0.995978,0,2,311913,310868,1045
1798441,134.643,249.99,2715,1460,0.996791,0,2,313583,310868,2715
1798441,131.943,167.473,3099,8760,0.9966,0,2,313967,310868,3099
1798441,121.45,146.539,3147,10220,0.995775,0,2,314015,310868,3147
1906481,134.451,297.749,983,18160,0.988104,0,2,314848,313865,983
1906481,143.145,260.53,1187,19620,0.972091,0,2,315052,313865,1187
1906481,146.877,227.964,1360,21080,0.96683,0,2,315225,313865,1360
1918801,350.017,506.969,672,1460,0.927226,0,2,316997,316325,672
1921721,500.765,627.098,760,5840,0.932573,0,2,318553,317793,760
1929021,486.919,524.161,1164,14600,0.949829,0,2,319905,318741,1164
1929021,308.419,205.836,2464,11680,0.956548,0,2,321205,318741,2464
1929021,301.366,180.106,2716,11680,0.94698,0,2,321457,318741,2716
1929021,289.195,157.593,2920,1460,0.952357,0,2,321661,318741,2920
1945081,243.444,146.575,2628,1460,0.982783,0,2,324289,321661,2628
1964061,185.391,284.997,1016,16060,0.986074,0,2,325717,324701,1016
1964061,189.429,111.917,2372,22332,0.992031,0,2,327073,324701,2372
1964061,194.25,97.9273,2600,22332,0.986777,0,2,327301,324701,2600
1999101,246.934,306.977,1141,5840,0.941956,0,2,329913,328772,1141
2000561,242.067,285.73,1212,5840,0.892962,0,2,330121,328909,1212
2000561,234.309,250.014,1392,5840,0.845091,0,2,330301,328909,1392
2000561,254.52,218.762,1788,5840,0.780705,0,2,330697,328909,1788
2000561,240.705,191.417,1932,22332,0.721867,0,2,330841,328909,1932
2003481,246.617,390.99,432,22332,0.667884,0,1,331129,330697,432
2009321,232.29,363.491,393,22332,0.625648,0,2,331261,330868,393
2012241,249.754,339.43,594,5840,0.596192,0,2,331633,331039,594
2015161,263.534,339.751,612,8760,0.575418,0,2,331993,331381,612
2018081,275.593,340.032,630,11680,0.569741,0,2,332353,331723,630
2019541,293.144,340.278,704,14600,0.582273,0,2,332769,332065,704
2021001,282.001,319.118,737,16060,0.603239,0,2,332973,332236,737
2023921,272.751,300.603,774,17520,0.629084,0,2,333181,332407,774
2025381,290.657,305.778,848,19743,0.669199,0,2,333597,332749,848
2037061,222.34,105.418,2244,7300,0.9367,0,2,336361,334117,2244
2047281,221.547,291.74,864,8760,0.935862,0,2,336577,335713,864
2075021,218.687,129.968,2633,1460,0.993257,0,2,342349,339716,2633
2085241,219.851,364.847,852,5840,0.9916,0,2,342577,341725,852
2091081,244.941,297.921,1081,11680,0.959441,0,2,343881,342800,1081
2092541,242.823,283.681,1125,5840,0.914511,0,2,344109,342984,1125
2092541,215.971,248.22,1153,5840,0.882697,0,2,344137,342984,1153
2092541,212.974,217.193,1345,5840,0.84861,0,2,344329,342984,1345
2092541,205.852,190.044,1501,5840,0.823784,0,2,344485,342984,1501
2092541,187.621,166.288,1561,4380,0.797061,0,2,344545,342984,1561
2092541,212.168,145.502,1945,4380,0.766178,0,2,344929,342984,1945
2101301,208.147,314.939,624,14600,0.741656,0,2,345109,344485,624
2102761,213.129,283.072,812,5840,0.722699,0,2,345357,344545,812
2104221,228.488,295.688,764,7300,0.708612,0,2,345693,344929,764
2105681,226.927,284.477,774,8760,0.696285,0,2,345909,345135,774
2108601,226.061,274.667,788,10220,0.693,0,2,346129,345341,788
2110061,254.303,291.834,828,13140,0.695125,0,2,346581,345753,828
2111521,248.015,281.105,826,14600,0.706984,0,2,346785,345959,826
2112981,244.013,271.717,836,16060,0.729861,0,2,347001,346165,836
2114441,239.012,263.502,834,17520,0.754878,0,2,347205,346371,834
2115901,237.635,256.314,856,17490,0.784269,0,2,347433,346577,856
2133421,223.783,216.134,1108,20368,0.945298,0,2,350157,349049,1108
2134881,191.319,82.3159,2280,11680,0.973704,0,2,351493,349213,2280
2146561,195.904,268.526,936,13140,0.965741,0,2,351721,350785,936
2146561,175.142,92.2681,2276,20440,0.979478,0,2,353061,350785,2276
2146561,180.249,80.7346,2492,1460,0.963293,0,2,353277,350785,2492
2146561,184.718,70.6427,2708,5840,0.962882,0,2,353493,350785,2708
2167001,175.562,231.649,1403,13140,0.981674,0,2,354623,353220,1403
2167001,177.616,202.693,1595,13140,0.977715,0,2,354815,353220,1595
2168821,541.378,616.405,1098,13500,0.970438,0,2,358109,357011,1098
2170281,499.206,559.605,1140,14960,0.940383,0,2,358313,357173,1140
2171741,462.305,509.904,1182,16420,0.906585,0,2,358517,357335,1182
2171741,406.517,446.166,1198,17880,0.875762,0,2,358533,357335,1198
2171741,381.202,390.395,1402,19340,0.842542,0,2,358737,357335,1402
2171741,348.552,341.596,1522,20800,0.805974,0,2,358857,357335,1522
2171741,316.983,298.896,1618,8760,0.773977,0,2,358953,357335,1618
2171741,286.36,261.534,1690,10220,0.74348,0,2,359025,357335,1690
2171741,261.065,228.843,1774,11680,0.714295,0,2,359109,357335,1774
2171741,244.932,200.237,1906,13140,0.698758,0,2,359241,357335,1906
2171741,230.816,175.208,2038,14600,0.692663,0,2,359373,357335,2038
2184881,209.464,343.557,576,16060,0.67983,0,2,359433,358857,576
2187801,211.781,312.862,706,5840,0.663602,0,2,359661,358955,706
2190721,227.308,314.254,718,8760,0.671901,0,2,359997,359279,718
2193641,246.895,322.722,720,11680,0.689164,0,2,360381,359661,720
2195101,251.533,310.632,778,14600,0.714268,0,2,360665,359887,778
2198021,232.591,285.928,765,16060,0.748735,0,2,360765,360000,765
2209701,197.318,72.9434,2640,13140,0.950002,0,2,363657,361017,2640
2227221,198.627,280.169,1251,14600,0.97907,0,2,365253,364002,1251
2249121,193.484,283.351,1251,14600,0.994676,0,2,368121,366870,1251
2249121,209.799,247.932,1575,16060,0.994091,0,2,368445,366870,1575
2249121,184.475,97.362,2691,1460,0.99268,0,2,369561,366870,2691
2249121,191.416,85.1917,2931,5840,0.978595,0,2,369801,366870,2931
2281241,202.996,236.632,1187,17520,0.989814,0,2,371549,370362,1187
2281241,181.122,207.053,1215,5840,0.978588,0,2,371577,370362,1215
2281241,186.981,181.171,1443,5840,0.962514,0,2,371805,370362,1443
2281241,190.609,158.525,1659,5840,0.94095,0,2,372021,370362,1659
2281241,178.783,138.709,1755,5840,0.922081,0,2,372117,370362,1755
2281241,166.935,121.371,1839,5840,0.905571,0,2,372201,370362,1839
2281241,156.568,106.199,1923,5840,0.891125,0,2,372285,370362,1923
2281241,150.497,92.9244,2031,5840,0.873484,0,2,372393,370362,2031
2284161,173.685,288.684,708,5840,0.858049,0,2,372729,372021,708
2285621,174.474,275.098,708,5840,0.842042,0,2,372909,372201,708
2295841,170.665,262.336,679,21357,0.830537,0,2,373053,372374,679
2297301,193.832,251.169,862,5840,0.81547,0,2,373409,372547,862
2300221,191.103,242.523,852,7300,0.799786,0,2,373581,372729,852
2301681,214.715,256.208,880,10220,0.788563,0,2,373961,373081,880
2304601,221.376,265.182,820,11680,0.781243,0,2,374229,373409,820
2307521,240.204,275.034,848,14600,0.792337,0,2,374601,373753,848
2310441,252.178,283.655,840,17520,0.807045,0,2,374937,374097,840
2322121,225.498,107.665,2292,8760,0.954744,0,2,377937,375645,2292
2344021,197.094,272.98,1020,14600,0.983893,0,2,379581,378561,1020
2349861,209.622,100.759,2488,7300,0.977161,0,2,382473,379985,2488
2349861,211.919,88.1644,2716,8760,0.976266,0,2,382701,379985,2716
2377601,238.689,293.375,1169,5840,0.973317,0,2,385673,384504,1169
2379061,237.353,281.203,1201,5840,0.932903,0,2,385901,384700,1201
2379061,211.184,246.053,1229,5840,0.89754,0,2,385929,384700,1229
2379061,210.286,215.296,1433,5840,0.841597,0,2,386133,384700,1433
2379061,193,188.384,1505,5840,0.790148,0,2,386205,384700,1505
2379061,222.875,164.836,1937,4380,0.710129,0,1,386637,384700,1937
2381981,202.516,332.357,492,19025,0.637613,0,1,386697,386205,492
2387821,210.201,344.812,324,19025,0.569161,0,1,386961,386637,324
2390741,213.926,319.711,420,5840,0.506766,0,1,387201,386781,420
2393661,221.685,315.747,408,8760,0.44967,0,1,387477,387069,408
2396581,228.35,312.278,395,11680,0.404712,0,1,387752,387357,395
2399501,243.306,309.244,455,14600,0.382873,0,1,388100,387645,455
2402421,253.393,306.588,491,17520,0.373764,0,2,388424,387933,491
2405341,266.719,304.265,563,20440,0.380793,0,2,388784,388221,563
2408261,276.879,302.232,623,20641,0.409444,0,2,389132,388509,623
2411181,285.769,300.453,683,20297,0.447013,0,2,389480,388797,683
2414101,295.048,298.896,755,20155,0.497387,0,2,389840,389085,755
2415561,302.667,297.534,823,23075,0.556463,0,2,390196,389373,823
2427241,240.79,98.8002,2551,8760,0.899414,0,2,392960,390409,2551
2427241,239.192,86.4502,2779,10220,0.893237,0,2,393188,390409,2779
2456441,225.977,166.793,2680,20440,0.99496,0,2,398900,396220,2680
2462281,180.534,386.811,900,5840,0.996771,0,2,400040,399140,900
2478341,183.468,352.46,992,5840,0.957175,0,2,400244,399252,992
2481261,186.034,322.402,1084,5840,0.920028,0,2,400448,399364,1084
2482721,188.28,296.102,1176,5840,0.891274,0,2,400652,399476,1176
2484181,190.245,329.589,816,5840,0.866115,0,2,400856,400040,816
2491481,179.964,313.891,720,23360,0.841601,0,2,400964,400244,720
2494401,199.469,300.154,852,24820,0.835151,0,2,401300,400448,852
2497321,212.035,313.635,744,27740,0.822007,0,2,401600,400856,744
2500241,218.531,302.431,784,27687,0.823006,0,2,401864,401080,784
2503161,222.714,292.627,812,27478,0.83388,0,2,402116,401304,812
2520681,205.051,128.378,2827,1460,0.991543,0,2,408092,405265,2827
2557181,189.652,315.352,1050,14600,0.995429,0,2,409364,408314,1050
2557181,194.445,275.933,1278,16060,0.981,0,2,409592,408314,1278
2557181,189.974,94.8131,2766,1460,0.988472,0,2,411080,408314,2766
2579081,176.436,241.11,1224,5840,0.989034,0,2,412652,411428,1224
2579081,187.382,210.971,1488,5840,0.979155,0,2,412916,411428,1488
2579081,187.959,184.6,1680,5840,0.96426,0,2,413108,411428,1680
2579081,182.464,161.525,1824,5840,0.944978,0,2,413252,411428,1824
2579081,249.656,141.334,2544,1460,0.878106,0,2,413972,411428,2544
2579081,225.949,123.668,2604,28989,0.817092,0,2,414032,411428,2604
2590761,248.706,425.834,471,29817,0.746206,0,1,414440,413969,471
2596601,229.617,386.48,456,29817,0.68668,0,1,414536,414080,456
2599521,223.415,352.045,525,29817,0.632095,0,1,414716,414191,525
2602441,219.488,335.789,495,28528,0.581833,0,1,414908,414413,495
2605361,219.052,321.566,489,27292,0.540354,0,1,415124,414635,489
2608281,218.671,309.12,483,20201,0.51156,0,2,415340,414857,483
2611201,221.337,298.23,501,19494,0.491365,0,2,415580,415079,501
2614121,234.17,293.951,561,18903,0.481194,0,2,415904,415343,561
2617041,251.399,295.457,627,18540,0.484795,0,2,416276,415649,627
2618501,262.974,296.775,665,18368,0.497946,0,2,416620,415955,665
2621421,251.602,278.803,684,18311,0.514452,0,2,416792,416108,684
2624341,265.152,282.203,738,18311,0.548896,0,2,417152,416414,738
2627261,277.008,285.177,792,18311,0.591534,0,2,417512,416720,792
2630181,287.382,287.78,846,18311,0.641342,0,2,417872,417026,846
2640401,219.05,89.8533,2568,16060,0.93554,0,2,420824,418256,2568
2643321,220.169,285.622,1140,17520,0.937348,0,2,421052,419912,1140
2643321,219.138,128.186,2460,18043,0.954382,0,2,422372,419912,2460
2644781,204.185,360.649,1291,13140,0.981285,0,2,424148,422857,1291
2685661,210.834,299.932,1523,5840,0.988725,0,2,427364,425841,1523
2700261,239.84,75.8924,3763,10220,0.990231,0,2,432800,429037,3763
2700261,233.826,17.4698,6283,26280,0.996501,0,2,435320,429037,6283
2700261,233.098,15.286,6511,1460,0.994439,0,2,435548,429037,6511
2745521,195.271,444.048,1517,18980,0.997287,0,2,437308,435791,1517
2745521,212.226,116.818,3766,10220,0.998036,0,2,439557,435791,3766
2745521,214.198,102.216,3994,11680,0.975782,0,2,439785,435791,3994
2745521,217.423,89.439,4234,13140,0.965059,0,2,440025,435791,4234
2745521,220.245,78.2591,4474,13140,0.955677,0,2,440265,435791,4474
2745521,213.715,68.4767,4642,13140,0.949967,0,2,440433,435791,4642
2745521,199.822,15.7627,6838,5840,0.984733,0,2,442629,435791,6838
2802461,148.759,118.415,2378,1460,0.996443,0,2,446001,443623,2378
2802461,158.664,103.613,2606,5840,0.980638,0,2,446229,443623,2606
2831661,166.115,205.439,1176,18980,0.991156,0,2,447849,446673,1176
2834581,165.597,348.349,1247,14600,0.986586,0,2,450537,449290,1247
2834581,173.397,304.805,1475,16060,0.985763,0,2,450765,449290,1475
2834581,189.239,136.795,2663,24820,0.992361,0,2,451953,449290,2663
2836041,192.984,184.681,2339,5840,0.997572,0,2,454545,452206,2339
2836041,195.861,161.596,2555,5840,0.989125,0,2,454761,452206,2555
2838961,291.378,483.396,779,27740,0.976735,0,2,455721,454942,779
2840421,272.956,440.597,782,24570,0.970893,0,2,455865,455083,782
2853561,256.836,403.147,785,24570,0.960781,0,2,456009,455224,785
2876921,236.732,370.379,740,24570,0.956934,0,2,456105,455365,740
2897361,228.14,341.707,767,24570,0.958567,0,2,456273,455506,767
2910501,205.715,104.736,2342,13140,0.982698,0,2,459117,456775,2342
2913421,214.181,406.13,825,10220,0.988485,0,2,460473,459648,825
2923641,217.409,372.989,924,11680,0.978674,0,2,460713,459789,924
2949921,213.575,323.368,1185,13140,0.995461,0,2,463725,462540,1185
2960141,266.137,311.795,1217,21900,0.990172,0,2,465305,464088,1217
2963061,231.75,386.207,1144,8760,0.964734,0,2,467937,466793,1144
2963061,231.281,337.931,1372,10220,0.910393,0,2,468165,466793,1372
2963061,227.871,295.69,1576,11680,0.857844,0,2,468369,466793,1576
2963061,217.387,258.728,1720,13140,0.819363,0,2,468513,466793,1720
2963061,208.214,226.387,1864,14600,0.788193,0,2,468657,466793,1864
2963061,191.187,198.089,1936,16060,0.758419,0,2,468729,466793,1936
2963061,173.289,173.328,1984,17520,0.734866,0,2,468777,466793,1984
2963061,169.628,151.662,2128,18980,0.724258,0,2,468921,466793,2128
2963061,167.924,132.704,2284,20440,0.724976,0,2,469077,466793,2284
2963061,166.434,116.116,2440,21900,0.725604,0,2,469233,466793,2440
2963061,157.63,101.602,2536,23360,0.731153,0,2,469329,466793,2536
2963061,154.426,88.9014,2668,1460,0.743509,0,2,469461,466793,2668
2963061,153.123,77.7887,2812,5840,0.751821,0,2,469605,466793,2812
2963061,151.982,68.0651,2956,7300,0.771593,0,2,469749,466793,2956
2963061,143.484,59.557,3040,8760,0.793894,0,2,469833,466793,3040
3008321,169.125,71.5316,2610,16060,0.975119,0,2,472665,470055,2610
3057961,162.169,237.796,1111,18980,0.994324,0,2,477165,476054,1111
3057961,170.398,208.071,1339,20440,0.993783,0,2,477393,476054,1339
3057961,160.039,71.4951,2575,32120,0.992864,0,2,478629,476054,2575
3057961,168.534,62.5582,2803,1460,0.986256,0,2,478857,476054,2803
3068181,183.418,127.898,2226,5840,0.993828,0,2,481281,479055,2226
3068181,187.491,111.911,2442,5840,0.965849,0,2,481497,479055,2442
3068181,194.055,97.9222,2682,33580,0.926368,0,2,481737,479055,2682
3068181,192.298,85.682,2862,26349,0.881822,0,2,481917,479055,2862
3084241,208.761,387.222,688,26349,0.827844,0,2,482241,481553,688
3085701,196.166,357.194,649,26349,0.780614,0,2,482349,481700,649
3091541,185.145,330.92,610,26349,0.731787,0,2,482457,481847,610
3104681,177.002,307.93,583,26349,0.689064,0,2,482577,481994,583
3107601,180.377,287.814,640,26349,0.651681,0,2,482781,482141,640
3110521,190.829,288.587,610,25316,0.628971,0,2,483045,482435,610
3113441,207.476,289.264,640,24323,0.621599,0,2,483369,482729,640
3114901,224.541,289.856,690,23528,0.632649,0,2,483713,483023,690
3117821,222.474,271.999,751,22972,0.657318,0,2,483921,483170,751
3119281,239.164,274.749,813,22634,0.693903,0,2,484277,483464,813
3122201,230.769,258.78,838,22495,0.725916,0,2,484449,483611,838
3133881,225.082,101.143,2443,10220,0.926045,0,2,487377,484934,2443
3133881,228.558,45.3925,3871,10220,0.958059,0,2,488805,484934,3871
3133881,226.988,39.7184,4087,11680,0.962052,0,2,489021,484934,4087
3133881,218.754,1.07947,10015,5840,0.991469,0,2,494949,484934,10015
3133881,216.91,0.944534,10219,5840,0.961285,0,2,495153,484934,10219
3133881,215.296,0.826467,10423,5840,0.924874,0,2,495357,484934,10423
3211261,266.601,143.153,3372,7300,0.986019,0,2,503745,500373,3372
3211261,260.275,125.258,3588,8760,0.985267,0,2,503961,500373,3588
3237541,246.133,589.495,1321,11680,0.988282,0,2,506853,505532,1321
3237541,232.588,231.492,2869,5840,0.992899,0,2,508401,505532,2869
3237541,232.014,202.556,3097,7300,0.991286,0,2,508629,505532,3097
3253601,231.513,481.486,891,8760,0.967376,0,2,508857,507966,891
3253601,229.573,421.3,1107,10220,0.940204,0,2,509073,507966,1107
3256521,215.877,416.263,846,10220,0.901428,0,2,509193,508347,846
3256521,212.892,364.23,1038,5840,0.8575,0,2,509385,508347,1038
3259441,213.281,365.201,882,5840,0.794062,0,2,509601,508719,882
3262361,213.621,361.426,763,5840,0.733554,0,2,509817,509054,763
3265281,231.918,384.623,576,21900,0.67061,0,1,510177,509601,576
3268201,237.428,375.545,540,22647,0.620534,0,1,510453,509913,540
3271121,245.25,367.602,528,21730,0.576717,0,1,510753,510225,528
3274041,259.593,360.652,576,20906,0.558377,0,2,511113,510537,576
3276961,272.144,354.57,624,20289,0.55483,0,2,511473,510849,624
3279881,283.126,349.249,672,19877,0.569227,0,2,511833,511161,672
3281341,296.735,344.593,752,19615,0.594323,0,2,512225,511473,752
3284261,282.644,321.019,780,19577,0.631283,0,2,512409,511629,780
3297401,235.529,125.432,2220,13140,0.918234,0,2,515409,513189,2220
3297401,234.588,109.753,2448,14600,0.924705,0,2,515637,513189,2448
3339741,228.217,608.447,962,13140,0.990695,0,2,521181,520219,962
3339741,228.19,532.391,1190,14600,0.986858,0,2,521409,520219,1190
3352881,191.207,384.184,960,5840,0.979234,0,2,522789,521829,960
3352881,194.306,336.161,1176,5840,0.95058,0,2,523005,521829,1176
3352881,219.518,294.141,1572,5840,0.903008,0,2,523401,521829,1572
3352881,216.078,257.374,1764,18980,0.851382,0,2,523593,521829,1764
3352881,210.068,225.202,1932,5840,0.806209,0,2,523761,521829,1932
3352881,210.81,197.052,2148,5840,0.759183,0,2,523977,521829,2148
3352881,197.959,172.42,2256,7300,0.710535,0,2,524085,521829,2256
3363101,177.714,371.368,528,8760,0.670468,0,2,524121,523593,528
3366021,199,345.947,708,5840,0.62791,0,2,524469,523761,708
3368941,199.625,348.453,546,8760,0.595671,0,2,524673,524127,546
3371861,221.172,347.647,576,11680,0.584962,0,2,525045,524469,576
3374781,234.025,339.441,618,14600,0.590592,0,2,525369,524751,618
3377701,252.772,331.761,724,17520,0.613018,0,2,525753,525029,724
3380621,255.675,325.041,722,20440,0.640141,0,2,526029,525307,722
3383541,270.216,319.161,816,21043,0.681373,0,2,526401,525585,816
3393761,301.957,300.128,1096,21881,0.809477,0,2,527777,526681,1096
3395221,223.043,109.557,2361,11680,0.929535,0,2,529173,526812,2361
3395221,223.662,95.8623,2589,13140,0.935843,0,2,529401,526812,2589
3395221,214.004,37.6447,4029,11680,0.971056,0,2,530841,526812,4029
3395221,224.402,16.8948,5409,17520,0.98326,0,2,532221,526812,5409
3395221,214.44,5.8052,7065,8760,0.990498,0,2,533877,526812,7065
3395221,214.451,0.89522,10017,5840,0.983535,0,2,536829,526812,10017
3395221,213.145,0.783317,10221,5840,0.945593,0,2,537033,526812,10221
3447781,605.002,1644.81,416,20537,0.893644,0,2,540381,539965,416
3450701,551.877,1457.71,448,21997,0.858188,0,2,540561,540113,448
3452161,508.392,1294,504,23043,0.839665,0,2,540765,540261,504
3459461,470.343,1150.75,560,23043,0.830957,0,2,540969,540409,560
3462381,456.55,1025.4,772,23043,0.845837,0,2,541329,540557,772
3474061,291.763,292.443,2380,11680,0.947013,0,2,544269,541889,2380
3476981,282.292,451.387,1032,1460,0.938636,0,2,544485,543453,1032
3509101,224.675,302.969,1181,11680,0.991284,0,2,548577,547396,1181
3512021,225.09,307.098,1073,11680,0.991123,0,2,548805,547732,1073
3512021,209.677,47.3576,3761,10220,0.961131,0,2,551493,547732,3761
3512021,210.468,41.4379,3977,11680,0.90599,0,2,551709,547732,3977
3512021,209.659,36.2581,4181,5840,0.846491,0,2,551913,547732,4181
3512021,198.452,31.7259,4301,5840,0.78443,0,2,552033,547732,4301
3512021,194.645,27.7601,4469,5840,0.730126,0,2,552201,547732,4469
3525161,422.315,762.54,579,26280,0.74011,0,2,554217,553638,579
3528081,383.025,681.223,575,27740,0.751346,0,2,554325,553750,575
3531001,353.147,610.07,607,29200,0.776178,0,2,554469,553862,607
3544141,328.504,547.811,651,30218,0.800406,0,2,554625,553974,651
3560201,199.038,395.448,1042,11680,0.979163,0,2,558825,557783,1042
3560201,202.658,346.017,1270,13140,0.975518,0,2,559053,557783,1270
3596701,195.913,103.417,2790,1460,0.992615,0,2,563541,560751,2790
3617141,188.963,331.554,978,13140,0.991686,0,2,564645,563667,978
3617141,195.342,290.109,1218,14600,0.968975,0,2,564885,563667,1218
3617141,205.425,253.846,1494,16060,0.945353,0,2,565161,563667,1494
3617141,199.247,222.115,1650,17520,0.918434,0,2,565317,563667,1650
3617141,195.341,194.351,1818,5840,0.89488,0,2,565485,563667,1818
3617141,187.423,170.057,1950,5840,0.87927,0,2,565617,563667,1950
3617141,174.495,148.8,2034,5840,0.865611,0,2,565701,563667,2034
3617141,163.183,130.2,2118,5840,0.85866,0,2,565785,563667,2118
3617141,156.285,113.925,2226,5840,0.860077,0,2,565893,563667,2226
3617141,145.75,99.6842,2298,5840,0.863818,0,2,565965,563667,2298
3644881,228.848,328.903,1032,8760,0.961321,0,2,569493,568461,1032
3644881,267.708,192.797,2292,11680,0.969827,0,2,570753,568461,2292
3644881,262.744,168.697,2520,11680,0.963598,0,2,570981,568461,2520
3671161,206.949,126.148,2438,14600,0.990088,0,2,573909,571471,2438
3685761,244.788,129.413,2551,17520,0.995504,0,2,576873,574322,2551
3685761,205.395,66.3771,3415,5840,0.986444,0,2,577737,574322,3415
3685761,191.721,58.0799,3511,5840,0.971888,0,2,577833,574322,3511
3687221,176.756,390.195,868,5840,0.954152,0,2,577905,577037,868
3688681,165.161,350.546,879,5840,0.928633,0,2,577989,577110,879
3690141,150.516,315.852,854,5840,0.902554,0,2,578037,577183,854
3703281,149.701,285.496,925,5840,0.882235,0,2,578181,577256,925
3704741,151.989,258.934,1020,5840,0.860705,0,2,578349,577329,1020
3707661,140.49,252.067,876,5840,0.841867,0,2,578409,577533,876
3713501,161.929,283.559,684,5840,0.817884,0,2,578721,578037,684
3716421,177.688,266.114,828,20440,0.801898,0,2,579009,578181,828
3717881,190.977,262.975,871,23360,0.795411,0,2,579293,578422,871
3720801,181.105,267.478,684,24820,0.792235,0,2,579405,578721,684
3723721,177.967,252.293,694,27740,0.789455,0,2,579561,578867,694
3726641,178.221,239.006,728,30660,0.807023,0,2,579741,579013,728
3729561,178.443,227.381,762,33580,0.827395,0,2,579921,579159,762
3732481,174.138,217.208,760,36500,0.847721,0,2,580065,579305,760
3754381,206.556,170.468,1244,39860,0.946426,0,2,581717,580473,1244
3754381,133.885,39.2402,2436,27740,0.982668,0,2,582909,580473,2436
3754381,142.022,9.03274,3996,17520,0.98851,0,2,584469,580473,3996
3754381,157.269,7.90364,4260,18980,0.986196,0,2,584733,580473,4260
3754381,229.875,4.63297,5580,23360,0.990659,0,2,586053,580473,5580
3754381,229.641,4.05385,5808,24820,0.989326,0,2,586281,580473,5808
3823001,171.791,254.096,1291,18980,0.994621,0,2,590685,589394,1291
3823001,181.817,222.334,1543,5840,0.994044,0,2,590937,589394,1543
3823001,193.59,194.542,1819,5840,0.983538,0,2,591213,589394,1819
3823001,194.891,170.224,2023,5840,0.969346,0,2,591417,589394,2023
3827381,317.53,474.946,591,24820,0.911928,0,2,592593,592002,591
3828841,288.339,433.703,530,26280,0.864187,0,2,592677,592147,530
3830301,268.796,397.615,517,26705,0.822413,0,2,592809,592292,517
3836141,256.197,366.038,540,26705,0.790862,0,2,592977,592437,540
3837601,240.672,338.408,527,23785,0.767004,0,2,593109,592582,527
3843441,231.588,314.232,550,23785,0.746128,0,2,593277,592727,550
3846361,235.64,289.453,698,23785,0.734112,0,2,593541,592843,698
3849281,244.56,282.272,773,23223,0.723598,0,2,593848,593075,773
3852201,254.49,289.363,758,22922,0.721899,0,2,594172,593414,758
3855121,260.179,289.442,768,22621,0.730411,0,2,594472,593704,768
3858041,268.156,289.512,802,22381,0.74036,0,2,594796,593994,802
3860961,275.137,289.573,836,22260,0.759065,0,2,595120,594284,836
3874101,227.996,100.461,2470,10220,0.948788,0,2,598204,595734,2470
3874101,276.724,26.4288,5290,14600,0.979027,0,2,601024,595734,5290
3874101,269.134,23.1252,5506,16060,0.972899,0,2,601240,595734,5506
3874101,235.44,9.08119,7032,8760,0.981857,0,2,602766,595734,7032
3919361,237.9,463.755,1194,16085,0.975376,0,2,604310,603116,1194
3919361,211.662,405.786,1222,16085,0.968454,0,2,604338,603116,1222
3919361,236.27,208.131,2554,5840,0.96382,0,2,605670,603116,2554
3922281,233.736,411.365,936,5840,0.947092,0,2,605886,604950,936
3923741,233.019,389.944,924,5840,0.929956,0,2,606114,605190,924
3932501,224.892,374.201,828,16085,0.899961,0,2,606282,605454,828
3933961,245.78,355.176,998,5840,0.843716,0,2,606674,605676,998
3936881,236.558,338.529,948,7300,0.797001,0,2,606846,605898,948
3938341,245.488,351.713,812,10220,0.753626,0,2,607154,606342,812
3939801,244.802,349.249,720,11680,0.713173,0,2,607394,606674,720
3941261,241.202,333.343,714,13140,0.680276,0,2,607610,606896,714
3942721,238.051,319.425,708,14600,0.653992,0,2,607826,607118,708
3944181,233.795,307.247,690,16060,0.638493,0,2,608030,607340,690
3947101,226.071,290.966,685,17520,0.629931,0,2,608202,607517,685
3948561,245.312,298.845,711,20106,0.64994,0,2,608582,607871,711
3950021,243.148,283.614,762,19875,0.667447,0,2,608810,608048,762
3952941,238.754,270.288,793,19759,0.702766,0,2,609018,608225,793
3974841,205.669,107.951,2376,17308,0.97575,0,2,613434,611058,2376
3974841,229.592,55.369,3660,10220,0.977562,0,2,614718,611058,3660
4015721,213.053,394.603,1032,5840,0.98146,0,2,620010,618978,1032
4018641,264.422,448.777,828,5840,0.947527,0,2,620634,619806,828
4020101,240.369,408.68,772,16060,0.912836,0,2,620706,619934,772
4025941,223.823,373.595,752,16060,0.884982,0,2,620814,620062,752
4027401,232.845,342.896,920,5840,0.868109,0,2,621110,620190,920
4030321,237.239,355.534,744,7300,0.863345,0,2,621378,620634,744
4031781,249.084,336.592,872,10220,0.879177,0,2,621710,620838,872
4046381,227.931,385.139,1097,10220,0.987828,0,2,625686,624589,1097
4046381,227.94,336.997,1325,11680,0.9831,0,2,625914,624589,1325
4091641,203.113,119.976,2725,23532,0.987264,0,2,632778,630053,2725
4091641,206.224,104.979,2953,23532,0.951356,0,2,633006,630053,2953
4091641,208.946,91.8564,3181,19701,0.913687,0,2,633234,630053,3181
4098941,206.828,384.874,937,19701,0.885726,0,2,633426,632489,937
4112081,194.474,355.765,893,19701,0.85876,0,2,633534,632641,893
4112081,180.665,311.294,977,21161,0.832665,0,2,633618,632641,977
4115001,168.582,310.383,757,21161,0.819832,0,2,633702,632945,757
4115001,158.009,271.585,841,22621,0.801103,0,2,633786,632945,841
4116461,179.758,280.387,831,22621,0.782215,0,2,634118,633287,831
4117921,182.788,269.088,845,24081,0.770688,0,2,634322,633477,845
4120841,175.44,259.202,779,25541,0.763102,0,2,634446,633667,779
4123761,180.51,260.052,729,28461,0.766464,0,2,634662,633933,729
4126681,192.446,256.046,777,28225,0.776906,0,2,634938,634161,777
4129601,195.39,252.54,765,27892,0.791043,0,2,635154,634389,765
4170481,198.488,154.632,1492,11680,0.987531,0,2,641046,639554,1492
4190921,209.14,45.363,3704,5840,0.970911,0,2,646530,642826,3704
4190921,211.498,39.6927,3932,5840,0.928297,0,2,646758,642826,3932
4190921,212.06,34.7311,4148,5840,0.88351,0,2,646974,642826,4148
4190921,257.553,30.3897,4724,20440,0.846821,0,2,647550,642826,4724
4190921,241.859,26.591,4856,21900,0.817219,0,2,647682,642826,4856
4190921,228.126,23.2671,4988,23360,0.798816,0,2,647814,642826,4988
4190921,214.611,20.3587,5108,24820,0.777714,0,2,647934,642826,5108
4190921,205.784,17.8139,5252,26280,0.77675,0,2,648078,642826,5252
4190921,195.061,15.5871,5372,27418,0.778406,0,2,648198,642826,5372
4190921,182.679,13.6388,5468,27418,0.792355,0,2,648294,642826,5468
4190921,180.844,11.9339,5636,27418,0.817061,0,2,648462,642826,5636
4190921,186.347,4.6864,6920,10220,0.926911,0,2,649746,642826,6920
4190921,205.33,2.10323,8252,16060,0.957198,0,2,651078,642826,8252
4190921,205.497,0.72269,9908,23630,0.980293,0,2,652734,642826,9908
4294581,201.447,420.072,1129,13140,0.99104,0,2,659814,658685,1129
4301881,204.766,415.563,973,13140,0.97091,0,2,660042,659069,973
4301881,206.17,363.617,1189,14600,0.937046,0,2,660258,659069,1189
4301881,201.399,318.165,1357,14600,0.916165,0,2,660426,659069,1357
4301881,189.724,278.394,1465,16060,0.899145,0,2,660534,659069,1465
4301881,182.508,243.595,1597,17520,0.888002,0,2,660666,659069,1597
4301881,176.195,213.146,1729,10220,0.880751,0,2,660798,659069,1729
4301881,166.171,186.503,1825,10220,0.881907,0,2,660894,659069,1825
4301881,157.399,163.19,1921,10220,0.877919,0,2,660990,659069,1921
4301881,149.724,142.791,2017,10220,0.881929,0,2,661086,659069,2017
4301881,149.009,124.942,2161,10220,0.887938,0,2,661230,659069,2161
4301881,146.883,109.324,2293,11680,0.894446,0,2,661362,659069,2293
4316481,131.522,295.284,720,13140,0.90514,0,2,661386,660666,720
4362081,188.556,329.76,964,14600,0.995364,0,2,670157,669193,964
4383981,172.107,301.788,1095,14600,0.965771,0,2,673037,671942,1095
4383981,177.594,264.064,1311,16060,0.9388,0,2,673253,671942,1311
4383981,180.894,231.056,1515,17520,0.9127,0,2,673457,671942,1515
4383981,176.283,202.174,1659,18980,0.884862,0,2,673601,671942,1659
4383981,160.247,176.902,1707,20440,0.863004,0,2,673649,671942,1707
4383981,158.216,154.79,1851,21900,0.843879,0,2,673793,671942,1851
4383981,142.939,135.441,1887,23360,0.829644,0,2,673829,671942,1887
4383981,143.072,118.511,2031,24820,0.817189,0,2,673973,671942,2031
4383981,144.688,103.697,2187,26280,0.80379,0,2,674129,671942,2187
4383981,141.602,90.7349,2307,27740,0.797066,0,2,674249,671942,2307
4383981,137.402,79.393,2415,29200,0.781183,0,2,674357,671942,2415
4383981,126.226,69.4689,2463,30660,0.767285,0,2,674405,671942,2463
4383981,117.948,60.7853,2523,32120,0.762624,0,2,674465,671942,2523
4383981,115.205,53.1871,2619,33580,0.753546,0,2,674561,671942,2619
4383981,106.804,46.5387,2667,1460,0.750603,0,2,674609,671942,2667
4383981,102.454,40.7214,2739,5840,0.748028,0,2,674681,671942,2739
4383981,100.147,35.6312,2823,7300,0.748274,0,2,674765,671942,2823
4383981,90.6285,31.1773,2847,8760,0.75349,0,2,674789,671942,2847
4383981,92.7999,27.2801,2955,10220,0.758054,0,2,674897,671942,2955
4383981,90.1999,23.8701,3027,11680,0.769547,0,2,674969,671942,3027
4383981,81.925,20.8864,3051,13140,0.777104,0,2,674993,671942,3051
4383981,82.1843,18.2756,3135,14600,0.793716,0,2,675077,671942,3135
4383981,82.4113,15.9911,3219,16060,0.810751,0,2,675161,671942,3219
4386901,78.1099,341.492,647,17520,0.830657,0,2,675209,674562,647
4388361,78.8461,307.431,662,18980,0.845575,0,2,675293,674631,662
4442381,213.363,291.549,782,6360,0.974163,0,2,677923,677141,782
4468921,216.479,105.903,2646,1460,0.996697,0,2,685243,682597,2646
4486441,195.69,293.257,1036,5840,0.984953,0,2,686527,685491,1036
4486441,199.729,256.6,1264,5840,0.951834,0,2,686755,685491,1264
4486441,203.263,224.525,1492,5840,0.934105,0,2,686983,685491,1492
4486441,267.855,196.459,2212,5840,0.903592,0,2,687703,685491,2212
4486441,315.373,171.902,2860,1460,0.901893,0,2,688351,685491,2860
4486441,302.951,150.414,3076,5840,0.910406,0,2,688567,685491,3076
4503961,236.452,147.175,2272,11680,0.970704,0,2,691327,689055,2272
4503961,240.192,11.6409,6664,8760,0.986433,0,2,695719,689055,6664
4503961,238.668,10.1858,6892,10220,0.978129,0,2,695947,689055,6892
4503961,250.56,5.2244,8224,16060,0.985032,0,2,697279,689055,8224
4503961,223.952,1.05228,10876,5840,0.973235,0,2,699931,689055,10876
4503961,224.458,0.920748,11104,5840,0.929081,0,2,700159,689055,11104
4503961,221.901,0.805655,11308,5840,0.891696,0,2,700363,689055,11308
4557981,318.663,1470.08,549,1460,0.841484,0,2,701359,700810,549
4569661,344.83,1354.94,528,18443,0.812548,0,2,701887,701359,528
4571121,353.727,1213.45,721,18443,0.80223,0,2,702303,701582,721
4572581,342.511,1089.65,762,17946,0.795701,0,2,702567,701805,762
4574041,329.697,981.315,779,17566,0.794988,0,2,702807,702028,779
4575501,321.485,886.525,820,17265,0.809365,0,2,703071,702251,820
4576961,312.799,803.585,849,17069,0.829444,0,2,703323,702474,849
4587181,214.116,26.6724,5466,18883,0.994694,0,2,709411,703945,5466
4587181,208.351,23.3384,5634,1460,0.994107,0,2,709579,703945,5634
4587181,203.494,10.4741,6827,11680,0.993605,0,2,710772,703945,6827
4587181,202.057,9.16488,7019,11680,0.990655,0,2,710964,703945,7019
4587181,200.8,8.01927,7211,11680,0.986823,0,2,711156,703945,7211
4587181,198.2,7.01686,7391,11680,0.97722,0,2,711336,703945,7391
4587181,200.05,6.13975,7604,13140,0.967568,0,2,711549,703945,7604
4587181,200.544,5.37228,7808,14600,0.959122,0,2,711753,703945,7808
4587181,220.726,4.70075,8170,16060,0.935481,0,2,712115,703945,8170
4587181,217.135,4.11315,8362,17520,0.909796,0,2,712307,703945,8362
4587181,218.118,3.59901,8587,18980,0.876072,0,2,712532,703945,8587
4587181,210.728,3.14913,8746,20440,0.840313,0,2,712691,703945,8746
4587181,204.262,2.75549,8905,20606,0.809024,0,2,712850,703945,8905
4587181,368.855,2.41105,10426,20606,0.724146,0,1,714371,703945,10426
4587181,349.748,2.10967,10642,5840,0.662377,0,1,714587,703945,10642
4641541,335.152,530.812,2144,7300,0.893491,0,2,718235,716091,2144
4641541,321.758,464.461,2372,8760,0.888055,0,2,718463,716091,2372
4651761,310.039,617.403,912,1460,0.898298,0,2,718691,717779,912
4651761,281.784,540.228,996,5840,0.899761,0,2,718775,717779,996
4651761,278.061,472.699,1248,7300,0.911041,0,2,719027,717779,1248
4680961,331.981,330.21,1124,13723,0.992593,0,2,725371,724247,1124
4686801,323.663,323.916,1064,16643,0.983158,0,2,726571,725507,1064
4689721,324.205,322.801,1077,16643,0.960263,0,2,726899,725822,1077
4692641,339.179,345.451,1017,16643,0.941481,0,2,727343,726326,1017
4694101,350.282,365.27,941,16981,0.915045,0,2,727771,726830,941
4695561,334.997,351.111,917,18441,0.894415,0,2,727999,727082,917
4697021,324.622,338.722,917,19402,0.878863,0,2,728251,727334,917
4698481,311.044,327.882,881,19402,0.870255,0,2,728467,727586,881
4701401,304.164,317.272,894,19402,0.872723,0,2,728723,727829,894
4702861,315.143,326.113,898,19629,0.884883,0,2,729115,728217,898
4713081,222.281,101.699,2408,8760,0.974712,0,2,731891,729483,2408
4716001,222.996,296.986,972,10220,0.969123,0,2,732119,731147,972
4742281,220.293,307.8,1128,11680,0.992058,0,2,734915,733787,1128
4758341,224.574,277.66,1209,13140,0.971428,0,2,738139,736930,1209
4758341,200.002,242.953,1237,14600,0.9475,0,2,738167,736930,1237
4758341,203.502,212.583,1465,16060,0.947812,0,2,738395,736930,1465
4758341,194.564,186.011,1597,17520,0.943086,0,2,738527,736930,1597
4777321,159.606,197.227,1184,5840,0.983149,0,2,740099,738915,1184
4777321,224.011,151.002,2024,5840,0.983348,0,2,740939,738915,2024
4793381,275.367,296.76,1113,13140,0.993744,0,2,743563,742450,1113
4794841,267.946,277.04,1190,14600,0.988276,0,2,743779,742589,1190
4813821,196.336,320.528,1009,13140,0.991116,0,2,746543,745534,1009
4813821,200.944,245.404,1441,14600,0.990698,0,2,746975,745534,1441
4838641,191.782,252.711,1044,16060,0.982316,0,2,749627,748583,1044
4838641,196.309,221.122,1272,17520,0.979526,0,2,749855,748583,1272
4838641,173.733,75.9796,2532,1460,0.989215,0,2,751115,748583,2532
4857621,176.108,296.417,1067,14600,0.982015,0,2,752387,751320,1067
4857621,182.595,259.365,1295,16060,0.973013,0,2,752615,751320,1295
4857621,185.27,226.944,1499,17520,0.970136,0,2,752819,751320,1499
4857621,186.111,198.576,1691,17520,0.970119,0,2,753011,751320,1691
4857621,176.348,173.754,1799,18980,0.967604,0,2,753119,751320,1799
4857621,159.579,133.031,2003,21900,0.973947,0,2,753323,751320,2003
4857621,146.177,101.852,2207,24820,0.976303,0,2,753527,751320,2207
4857621,166.905,89.1201,2519,26280,0.970515,0,2,753839,751320,2519
4857621,156.542,77.9801,2603,1460,0.972951,0,2,753923,751320,2603
4857621,153.474,68.2325,2735,5840,0.967582,0,2,754055,751320,2735
4857621,141.504,52.2405,2939,8760,0.97393,0,2,754259,751320,2939
4857621,137.316,45.7105,3047,10220,0.973439,0,2,754367,751320,3047
4857621,129.32,34.9971,3251,13140,0.978414,0,2,754571,751320,3251
4863461,122.155,348.622,779,14600,0.979862,0,2,754643,753864,779
4888281,122.4,278.727,923,17520,0.983332,0,2,754895,753972,923
4907261,212.103,180.732,1620,10220,0.993846,0,2,758903,757283,1620
4916021,221.771,223.326,1326,10220,0.988488,0,2,760283,758957,1326
4916021,228.355,87.6994,2970,7300,0.987979,0,2,761927,758957,2970
4916021,236.256,7.92759,7230,5840,0.958913,0,2,766187,758957,7230
4916021,235.224,6.93664,7458,5840,0.920299,0,2,766415,758957,7458
4965661,430.636,625.365,1147,18825,0.958537,0,2,772955,771808,1147
4968581,312.447,272.987,2291,7300,0.981218,0,2,774555,772264,2291
4981721,269.007,349.906,1331,10220,0.987821,0,2,775971,774640,1331
5006541,257.66,278.642,1178,17520,0.969037,0,2,780515,779337,1178
5008001,255.453,267.062,1232,18980,0.930407,0,2,780755,779523,1232
5008001,227.021,233.679,1260,20440,0.899106,0,2,780783,779523,1260
5008001,225.644,204.469,1476,21900,0.867968,0,2,780999,779523,1476
5008001,209.438,178.91,1572,22087,0.830722,0,2,781095,779523,1572
5008001,201.258,156.547,1716,7300,0.805632,0,2,781239,779523,1716
5008001,194.101,136.978,1860,7300,0.778678,0,2,781383,779523,1860
5008001,183.338,119.856,1968,7300,0.760093,0,2,781491,779523,1968
5008001,176.921,104.874,2100,8760,0.743831,0,2,781623,779523,2100
5019681,160.806,288.265,576,10220,0.724602,0,2,781671,781095,576
5022601,187.205,270.232,804,5840,0.710277,0,2,782043,781239,804
5025521,205.805,282.953,768,8760,0.710243,0,2,782379,781611,768
5028441,234.079,301.584,768,11680,0.730212,0,2,782811,782043,768
5038661,211.593,88.1898,2464,11680,0.945896,0,2,785787,783323,2464
5038661,215.144,77.166,2704,1460,0.943909,0,2,786027,783323,2704
5062021,192.666,112.561,2339,10220,0.990878,0,2,788943,786604,2339
5062021,200.928,44.2022,3791,11680,0.987668,0,2,790395,786604,3791
5062021,213.582,6.81642,6863,11680,0.991848,0,2,793467,786604,6863
5062021,211.216,4.56647,7487,5840,0.980789,0,2,794091,786604,7487
5062021,207.314,3.99566,7667,5840,0.94194,0,2,794271,786604,7667
5062021,199.4,3.4962,7811,5840,0.887948,0,2,794415,786604,7811
5110201,471.113,686.056,1842,8760,0.953498,0,2,800570,798728,1842
5110201,440.724,600.299,2070,8760,0.93806,0,2,800798,798728,2070
5152541,245.461,312.34,1064,8760,0.972622,0,2,807830,806766,1064
5152541,243.278,273.297,1292,8760,0.946044,0,2,808058,806766,1292
5155461,238.368,318.26,863,8760,0.914039,0,2,808262,807399,863
5158381,231.072,305.603,826,10220,0.876034,0,2,808442,807616,826
5161301,241.188,294.527,921,11680,0.83778,0,2,808754,807833,921
5164221,250.04,311.961,799,14600,0.789307,0,2,809066,808267,799
5167141,254.785,321.716,697,17520,0.751894,0,2,809354,808657,697
5170061,263.437,324.752,675,20440,0.711657,0,2,809678,809003,675
5172981,271.007,327.408,653,20405,0.68645,0,2,810002,809349,653
5174441,284.631,329.732,687,19947,0.696894,0,2,810382,809695,687
5183201,281.371,267.876,1065,19396,0.842034,0,2,811798,810733,1065
5186121,224.799,110.242,2223,7300,0.935722,0,2,813302,811079,2223
5196341,222.034,126.936,2256,14600,0.972258,0,2,814826,812570,2256
5219701,256.782,271.335,1127,7300,0.985202,0,2,817450,816323,1127
5221161,253.185,262.543,1154,8760,0.980802,0,2,817678,816524,1154
5229921,251.607,246.792,1188,17520,0.990134,0,2,819166,817978,1188
5229921,225.156,215.943,1228,18980,0.983867,0,2,819206,817978,1228
5243061,240.756,396.684,885,5840,0.982006,0,2,821582,820697,885
5247441,239.162,372.224,912,5840,0.929255,0,2,821810,820898,912
5247441,236.267,325.696,1128,5840,0.889348,0,2,822026,820898,1128
5250361,245.733,335.234,1038,5840,0.84193,0,2,822338,821300,1038
5253281,249.517,357.08,804,18668,0.792938,0,2,822614,821810,804
5256201,275.327,378.445,732,18266,0.752571,0,2,823070,822338,732
5257661,292.911,387.389,698,17786,0.72725,0,2,823486,822788,698
5259121,286.297,367.09,713,19246,0.722594,0,2,823726,823013,713
5260581,282.01,349.329,740,19851,0.728519,0,2,823978,823238,740
5262041,278.259,333.788,767,19552,0.746204,0,2,824230,823463,767
5273721,231.758,130.513,2065,7300,0.936381,0,2,827013,824948,2065
5291241,211.678,156.935,1942,11680,0.986439,0,2,830001,828059,1942
5311681,222.565,151.877,2172,13140,0.996562,0,2,834333,832161,2172
5330661,217.82,397.412,810,25998,0.970957,0,2,835605,834795,810
5333581,213.093,367.235,834,27458,0.947087,0,2,835785,834951,834
5339421,210.456,340.831,870,27589,0.937451,0,2,835977,835107,870
5339421,202.149,298.227,1014,24669,0.92652,0,2,836121,835107,1014
5342341,191.88,291.949,886,24669,0.921955,0,2,836241,835355,886
5345261,194.895,286.455,854,24313,0.922961,0,2,836457,835603,854
5348181,203.533,281.648,870,23920,0.93134,0,2,836721,835851,870
5361321,228.332,137.026,2106,8760,0.982945,0,2,839505,837399,2106
5378841,212.317,128.275,2464,1460,0.994494,0,2,842265,839801,2464
5378841,214.277,112.241,2692,5840,0.988932,0,2,842493,839801,2692
5394901,211.515,41.288,4271,17520,0.995484,0,2,846645,842374,4271
5394901,195.042,18.5299,5387,5840,0.991723,0,2,847761,842374,5387
5394901,191.662,16.2136,5555,5840,0.989008,0,2,847929,842374,5555
5394901,194.704,14.1869,5771,5840,0.970382,0,2,848145,842374,5771
5419721,194.366,643.039,918,19674,0.955334,0,2,848337,847419,918
5419721,183.571,562.659,1026,19674,0.947167,0,2,848445,847419,1026
5429941,183.124,542.576,804,19674,0.945021,0,2,848625,847821,804
5450381,256.331,334.291,1022,19457,0.974844,0,2,851657,850635,1022
5451841,251.29,317.63,1037,20917,0.969239,0,2,851873,850836,1037
5494181,208.404,118.972,2397,16060,0.998558,0,2,860175,857778,2397
5494181,210.853,104.101,2625,17520,0.994988,0,2,860403,857778,2625
5535061,203.605,254.389,960,13140,0.998403,0,2,864543,863583,960
5586161,211.602,263.419,1101,11680,0.994993,0,2,873471,872370,1101
5586161,215.152,230.491,1341,11680,0.990619,0,2,873711,872370,1341
5586161,218.532,103.443,2685,7300,0.99204,0,2,875055,872370,2685
5600761,249.451,317.862,1138,11680,0.991428,0,2,876599,875461,1138
5602221,238.862,137.389,2502,5840,0.989134,0,2,878187,875685,2502
5610981,233.005,341.466,924,1460,0.984242,0,2,878379,877455,924
5635801,234.582,242.802,1082,18518,0.995004,0,2,882935,881853,1082
5662081,229.887,282.362,956,10220,0.993298,0,2,887067,886111,956
5672301,272.289,287.198,1084,20440,0.994063,0,2,888683,887599,1084
5692741,218.211,284.216,912,22087,0.997834,0,2,891531,890619,912
5710261,210.373,200.084,1280,21712,0.995916,0,2,894699,893419,1280
5727781,227.705,131.536,2774,5840,0.994677,0,2,898887,896113,2774
5740921,252.642,325.139,1146,11680,0.988861,0,2,900443,899297,1146
5768661,281.79,258.374,1824,7300,0.995855,0,2,906235,904411,1824
5774501,275.028,402.522,1032,8760,0.986624,0,2,907603,906571,1032
5781801,269.15,366.082,1149,10220,0.974546,0,2,907831,906682,1149
5811001,184.055,313.523,1305,14600,0.99007,0,2,912379,911074,1305
5811001,198.361,123.119,2757,1460,0.98985,0,2,913831,911074,2757
5838741,211.2,322.569,1036,13140,0.991695,0,2,915155,914119,1036
5838741,214.925,282.248,1277,14600,0.973983,0,2,915396,914119,1277
5838741,212.059,246.967,1469,16060,0.965985,0,2,915588,914119,1469
5838741,206.552,216.096,1637,17520,0.966487,0,2,915756,914119,1637
5838741,198.733,189.084,1781,18980,0.969426,0,2,915900,914119,1781
5838741,178.592,144.767,2009,21900,0.972842,0,2,916128,914119,2009
5838741,173.86,110.838,2321,24820,0.977957,0,2,916440,914119,2321
5863561,173.133,255.702,1252,14600,0.990873,0,2,918006,916754,1252
5866481,197.991,295.74,1048,14600,0.988264,0,2,918378,917330,1048
5869401,207.742,298.522,1006,17520,0.979731,0,2,918654,917648,1006
5872321,220.775,303.207,982,20440,0.963514,0,2,918966,917984,982
5875241,230.303,307.306,943,23116,0.956825,0,2,919263,918320,943
5878161,240.515,310.893,919,22925,0.958472,0,2,919575,918656,919
5888381,302.641,321.283,1119,22421,0.971907,0,2,921119,920000,1119
5889841,206.697,90.8354,2623,1460,0.991359,0,2,922791,920168,2623
5911741,179.572,245.789,1478,14600,0.992402,0,2,924255,922777,1478
5911741,182.862,110.309,2606,5840,0.99534,0,2,925383,922777,2606
5927801,211.051,274.573,1182,13140,0.989649,0,2,927083,925901,1182
5927801,188.17,240.251,1210,14600,0.982193,0,2,927111,925901,1210
5949701,207.102,135.114,2034,4380,0.981268,0,2,931287,929253,2034
5951161,218.714,318.475,732,4380,0.954859,0,2,931587,930855,732
5959921,216.875,304.166,732,17520,0.941752,0,2,931791,931059,732
5961381,249.266,294.645,980,5840,0.940283,0,2,932267,931287,980
5971601,229.46,114.068,2380,11680,0.977972,0,2,935091,932711,2380
5971601,227.778,99.8099,2596,13140,0.976975,0,2,935307,932711,2596
6005181,209.224,114.947,2729,5840,0.991874,0,2,940851,938122,2729
6078181,236.97,105.73,3229,8760,0.993748,0,2,952575,949346,3229
6078181,223.041,18.6338,6113,8760,0.993898,0,2,955459,949346,6113
6078181,221.678,7.31742,7613,14600,0.986354,0,2,956959,949346,7613
6078181,230.671,1.47385,10469,19262,0.982251,0,2,959815,949346,10469
6078181,230.337,1.28962,10697,19262,0.96572,0,2,960043,949346,10697
6097161,236.352,1402.33,947,10220,0.974615,0,2,961507,960560,947
6097161,243.83,629.359,2447,1460,0.978607,0,2,963007,960560,2447
6165781,228.555,536.723,1129,13140,0.989149,0,2,964315,963186,1129
6176001,267.229,417.66,1149,21900,0.993185,0,2,965895,964746,1149
6177461,219.156,173.214,2273,10220,0.991074,0,2,967183,964910,2273
6177461,218.761,151.562,2489,11680,0.983439,0,2,967399,964910,2489
6190601,185.667,57.4585,3216,10220,0.990265,0,2,970015,966799,3216
6190601,189.459,50.2762,3432,11680,0.987732,0,2,970231,966799,3432
6218341,216.365,677.486,891,10220,0.986588,0,2,973039,972148,891
6222721,275.055,531.927,1043,14600,0.990888,0,2,974463,973420,1043
6224181,278.173,503.436,1039,14775,0.983277,0,2,974763,973724,1039
6231481,292.74,406.292,1043,14603,0.986423,0,2,976287,975244,1043
6237321,310.387,363.962,1123,14517,0.987041,0,2,977583,976460,1123
6238781,301.589,356.467,1059,14517,0.986161,0,2,977823,976764,1059
6251921,305.212,312.15,1096,17379,0.980839,0,2,980535,979439,1096
6253381,297.061,303.506,1093,17379,0.971984,0,2,980775,979682,1093
6272361,248.78,124.934,2310,7300,0.992468,0,2,985047,982737,2310
6286961,229.961,255.202,1168,11680,0.994542,0,2,986547,985379,1168
6289881,247.064,284.764,1008,13140,0.994571,0,2,987167,986159,1008
6291341,252.181,281.668,1036,14600,0.994,0,2,987455,986419,1036
6294261,257.498,276.59,1069,16194,0.982906,0,2,988008,986939,1069
6297181,251.311,274.516,1017,16194,0.970043,0,2,988216,987199,1017
6298641,273.397,305.202,925,16194,0.971288,0,2,988644,987719,925
6313241,302.236,303.624,1071,5840,0.987617,0,2,991314,990243,1071
6352661,254.47,261.054,1136,22260,0.990956,0,2,998190,997054,1136
6354121,252.662,254.548,1167,22260,0.990836,0,2,998430,997263,1167
6354121,212.612,99.9598,2395,8760,0.988901,0,2,999658,997263,2395
6365801,214.535,287.84,1020,1460,0.982789,0,2,999886,998866,1020
6387701,201.672,103.001,2460,13140,0.985782,0,2,1005670,1003210,2460
6387701,204.963,90.1261,2688,1460,0.970059,0,2,1005898,1003210,2688
6387701,204.843,78.8604,2892,5840,0.967552,0,2,1006102,1003210,2892
6387701,198.737,69.0028,3048,7300,0.965358,0,2,1006258,1003210,3048
6387701,187.395,60.3775,3156,8760,0.963438,0,2,1006366,1003210,3156
6416901,185.044,79.3755,2613,1460,0.994195,0,2,1009354,1006741,2613
6437341,164.072,21.9007,3876,16060,0.993592,0,2,1013446,1009570,3876
6437341,197.284,9.82895,5208,30660,0.995874,0,2,1014778,1009570,5208
6485521,188.255,321.032,1170,40880,0.97713,0,2,1016106,1014936,1170
6485521,169.723,280.903,1210,42340,0.963739,0,2,1016146,1014936,1210
6485521,175.508,245.79,1426,43800,0.954521,0,2,1016362,1014936,1426
6485521,159.793,19.4409,4054,16060,0.995153,0,2,1018990,1014936,4054
6485521,169.819,17.0108,4294,17520,0.977009,0,2,1019230,1014936,4294
6485521,177.091,14.8845,4522,18980,0.972383,0,2,1019458,1014936,4522
6485521,227.116,8.725,5717,1460,0.978811,0,2,1020653,1014936,5717
6485521,222.726,7.63437,5909,5840,0.97146,0,2,1020845,1014936,5909
6485521,223.385,6.68008,6137,7300,0.967527,0,2,1021073,1014936,6137
6494281,214.962,688.72,830,8760,0.970336,0,2,1021229,1020399,830
6498661,218.092,634.38,816,10220,0.972794,0,2,1021469,1020653,816
6500121,195.955,562.208,800,11680,0.973695,0,2,1021510,1020710,800
6548301,163.352,100.148,2379,1460,0.988144,0,2,1024313,1021934,2379
6614001,196.266,286.102,1108,14600,0.992435,0,2,1031441,1030333,1108
6614001,200.233,250.339,1336,16060,0.989631,0,2,1031669,1030333,1336
6640281,214.302,262.434,1218,28661,0.992526,0,2,1034797,1033579,1218
6640281,191.015,229.63,1246,28661,0.98721,0,2,1034825,1033579,1246
6640281,168.723,78.903,2506,16060,0.993105,0,2,1036085,1033579,2506
6669481,207.352,135.33,2176,11680,0.989377,0,2,1039685,1037509,2176
6669481,209.933,118.414,2404,1460,0.980705,0,2,1039913,1037509,2404
6682621,207.068,115.191,2716,1460,0.995774,0,2,1042781,1040065,2716
6682621,219.684,100.792,3024,5840,0.986303,0,2,1043089,1040065,3024
6711821,173.8,221.155,1136,18980,0.995147,0,2,1044561,1043425,1136
6736641,173.139,86.0477,2258,5840,0.973553,0,2,1048737,1046479,2258
6736641,179.996,75.2917,2486,5840,0.938109,0,2,1048965,1046479,2486
6738101,182.997,273.13,1032,5840,0.915845,0,2,1049169,1048137,1032
6739561,224.622,342.489,720,5840,0.895115,0,2,1049685,1048965,720
6751241,219.044,325.178,696,20440,0.874475,0,2,1049865,1049169,696
6751241,254.664,284.531,1200,20440,0.876416,0,2,1050369,1049169,1200
6751241,236.331,248.964,1308,21900,0.883114,0,2,1050477,1049169,1308
6751241,215.789,217.844,1380,21900,0.896475,0,2,1050549,1049169,1380
6751241,199.316,190.613,1464,21900,0.908165,0,2,1050633,1049169,1464
6774601,209.034,109.546,2517,20440,0.978754,0,2,1055901,1053384,2517
6774601,211.405,95.8526,2745,1460,0.97266,0,2,1056129,1053384,2745
6774601,213.479,83.871,2973,5840,0.969827,0,2,1056357,1053384,2973
6831541,131.249,210.243,1152,23360,0.990701,0,2,1060737,1059585,1152
6834461,162.137,89.9125,2208,26484,0.994305,0,2,1062153,1059945,2208
6834461,170.37,78.6735,2436,26484,0.970017,0,2,1062381,1059945,2436
6834461,174.574,68.8393,2640,1460,0.962515,0,2,1062585,1059945,2640
6834461,173.752,60.2344,2808,5840,0.95595,0,2,1062753,1059945,2808
6834461,168.533,52.7051,2940,7300,0.947706,0,2,1062885,1059945,2940
6834461,162.466,46.1169,3060,8760,0.947993,0,2,1063005,1059945,3060
6834461,158.658,40.3523,3192,10220,0.945744,0,2,1063137,1059945,3192
6850521,150.826,350.433,767,11680,0.943776,0,2,1063233,1062466,767
6853441,152.973,325.629,783,13140,0.942054,0,2,1063401,1062618,783
6862201,151.851,303.925,775,14600,0.945547,0,2,1063545,1062770,775
6862201,147.87,265.935,895,16060,0.943604,0,2,1063665,1062770,895
6862201,154.886,232.693,1099,16060,0.949403,0,2,1063869,1062770,1099
6876801,196.287,168.163,1526,32120,0.973881,0,2,1065429,1063903,1526
6876801,198.751,147.143,1742,33580,0.975896,0,2,1065645,1063903,1742
6888481,261.172,328.702,684,11680,0.989218,0,2,1068206,1067522,684
6902281,214.171,349.202,1098,11680,0.984587,0,2,1071060,1069962,1098
6902281,224.688,31.5662,5202,5840,0.997357,0,2,1075164,1069962,5202
6902281,225.102,27.6204,5430,5840,0.992687,0,2,1075392,1069962,5430
6905201,325.964,738.918,744,21900,0.962351,0,2,1076424,1075680,744
6906661,306.219,671.428,713,20125,0.935807,0,2,1076592,1075879,713
6943161,290.442,612.375,694,20125,0.912581,0,2,1076772,1076078,694
6944621,298.636,560.703,851,20125,0.892259,0,2,1077128,1076277,851
6947541,285.807,515.49,848,19803,0.879476,0,2,1077324,1076476,848
6949001,303.581,500.804,878,19510,0.893292,0,2,1077752,1076874,878
6954841,273.151,375.912,994,21975,0.9362,0,2,1078664,1077670,994
6960681,275.164,329.908,1119,21975,0.956009,0,2,1079505,1078386,1119
6962141,267.768,308.544,1176,21975,0.960258,0,2,1079721,1078545,1176
6970901,226.687,393.146,957,10220,0.990745,0,2,1082150,1081193,957
6970901,228.703,176.442,2337,17520,0.994596,0,2,1083530,1081193,2337
7014701,221.833,190.459,1812,5840,0.988499,0,2,1088834,1087022,1812
7014701,222.604,166.652,2040,5840,0.962437,0,2,1089062,1087022,2040
7014701,223.279,145.82,2268,5840,0.934632,0,2,1089290,1087022,2268
7014701,210.369,127.593,2388,5840,0.909053,0,2,1089410,1087022,2388
7022001,236.573,366.644,768,1460,0.876672,0,2,1089830,1089062,768
7022001,226.501,320.813,924,19376,0.840838,0,2,1089986,1089062,924
7029301,214.688,333.837,631,19376,0.819483,0,2,1090118,1089487,631
7029301,192.352,292.107,667,19376,0.798298,0,2,1090154,1089487,667
7029301,205.808,255.594,967,19376,0.77476,0,2,1090454,1089487,967
7032221,231.082,294.019,812,19376,0.751665,0,2,1090862,1090050,812
7035141,251.697,312.267,768,18926,0.731457,0,2,1091258,1090490,768
7036601,275.235,328.234,768,18565,0.723775,0,2,1091698,1090930,768
7038061,269.331,314.704,776,18152,0.719553,0,2,1091926,1091150,776
7039521,267.164,302.866,808,17805,0.720859,0,2,1092178,1091370,808
7040981,260.769,292.383,805,17552,0.732002,0,2,1092394,1091589,805
7042441,256.673,283.21,814,17325,0.751751,0,2,1092622,1091808,814
7061421,237.34,224.816,1143,20059,0.948749,0,2,1095754,1094611,1143
7093541,226.983,130.482,2338,7300,0.992817,0,2,1102790,1100452,2338
7103761,227.056,187.239,1824,5840,0.991316,0,2,1103918,1102094,1824
7103761,242.174,163.834,2172,20393,0.951151,0,2,1104266,1102094,2172
7112521,240.402,338.355,840,21853,0.906007,0,2,1104494,1103654,840
7115441,244.852,320.061,924,5840,0.861506,0,2,1104770,1103846,924
7118361,245.746,328.053,792,8760,0.817568,0,2,1105022,1104230,792
7121281,276.527,354.546,744,11680,0.786622,0,2,1105514,1104770,744
7124201,291.462,358.228,756,14600,0.769544,0,2,1105910,1105154,756
7125661,304.029,361.45,764,17520,0.772101,0,2,1106302,1105538,764
7127121,294.525,340.268,800,18980,0.786839,0,2,1106530,1105730,800
7128581,283.21,321.735,812,19238,0.807234,0,2,1106734,1105922,812
7140261,241.755,54.4582,3636,8760,0.979753,0,2,1111094,1107458,3636
7140261,229.947,10.9688,6396,8760,0.990922,0,2,1113854,1107458,6396
7140261,218.076,1.13317,10128,5840,0.990312,0,2,1117586,1107458,10128
7140261,216.317,0.991527,10332,5840,0.955273,0,2,1117790,1107458,10332
7140261,216.277,0.867586,10548,5840,0.902114,0,2,1118006,1107458,10548
7189901,364.742,1443.26,412,1460,0.8331,0,2,1119410,1118998,412
7192821,374.65,1314.35,444,17585,0.785212,0,2,1119854,1119410,444
7200121,360.818,1178.81,478,17585,0.763311,0,2,1120118,1119640,478
7201581,378.216,1060.21,748,17585,0.779147,0,2,1120618,1119870,748
7203041,366.939,956.431,806,17192,0.803004,0,2,1120906,1120100,806
7232241,244.051,274.93,1170,21061,0.981918,0,2,1125502,1124332,1170
7249761,210.568,38.4826,4554,14600,0.992124,0,2,1131423,1126869,4554
7249761,238.247,33.6722,4986,16060,0.966858,0,2,1131855,1126869,4986
7249761,235.466,29.4632,5202,16060,0.934751,0,2,1132071,1126869,5202
7249761,228.533,25.7803,5382,17520,0.904157,0,2,1132251,1126869,5382
7249761,214.966,22.5578,5502,18605,0.872387,0,2,1132371,1126869,5502
7249761,201.595,19.738,5610,18605,0.849589,0,2,1132479,1126869,5610
7273121,186.896,641.646,699,18605,0.82464,0,2,1132563,1131864,699
7273121,190.534,561.44,915,20065,0.79781,0,2,1132779,1131864,915
7273121,196.717,491.26,1155,20065,0.774334,0,2,1133019,1131864,1155
7274581,222.627,523.353,811,20065,0.758792,0,2,1133423,1132612,811
7277501,213.299,483.433,755,21525,0.750193,0,2,1133571,1132816,755
7280421,231.637,463.754,789,22328,0.770169,0,2,1133931,1133142,789
7302321,225.521,167.94,1968,16060,0.971821,0,2,1138479,1136511,1968
7328601,244.839,207.166,1608,13140,0.994953,0,2,1142667,1141059,1608
7346121,206.692,223.829,1064,11680,0.994516,0,2,1144155,1143091,1064
7346121,204.274,114.804,2096,5840,0.989687,0,2,1145187,1143091,2096
7346121,205.74,100.453,2312,5840,0.957226,0,2,1145403,1143091,2312
7346121,208.522,87.8967,2540,1460,0.906323,0,2,1145631,1143091,2540
7346121,243.957,76.9096,3032,5840,0.854283,0,2,1146123,1143091,3032
7353421,226.963,382.171,621,18980,0.803747,0,2,1146231,1145610,621
7357801,207.592,351.4,557,20440,0.767029,0,2,1146303,1145746,557
7357801,199.643,307.475,701,21900,0.7274,0,2,1146447,1145746,701
7360721,203.188,303.04,657,21900,0.695225,0,2,1146675,1146018,657
7363641,209.289,299.16,637,24820,0.674572,0,2,1146927,1146290,637
7366561,220.628,295.765,665,25291,0.671501,0,2,1147227,1146562,665
7369481,230.55,292.795,693,25083,0.693813,0,2,1147527,1146834,693
7397221,211.312,357.537,1303,13140,0.989482,0,2,1154669,1153366,1303
7397221,220.898,312.845,1591,14600,0.982047,0,2,1154957,1153366,1591
7435181,162.318,278.215,1047,16060,0.996327,0,2,1157480,1156433,1047
7435181,159.815,109.254,2211,5840,0.996058,0,2,1158644,1156433,2211
7435181,168.338,95.5973,2439,5840,0.956551,0,2,1158872,1156433,2439
7435181,174.546,83.6476,2657,5840,0.900732,0,2,1159090,1156433,2657
7435181,178.228,73.1917,2861,23360,0.84189,0,2,1159294,1156433,2861
7438101,203.949,399.793,559,24820,0.772904,0,1,1159678,1159119,559
7443941,184.456,362.319,507,26280,0.717541,0,2,1159726,1159219,507
7445401,168.899,329.529,467,27740,0.669098,0,2,1159786,1159319,467
7457081,153.786,300.838,415,29200,0.626711,0,2,1159834,1159419,415
7460001,149.563,275.733,435,30660,0.592122,0,2,1159954,1159519,435
7462921,138.368,253.766,395,32120,0.564357,0,2,1160014,1159619,395
7465841,148.072,234.546,511,32791,0.547562,0,2,1160230,1159719,511
7468761,159.563,230.227,551,31273,0.540367,0,2,1160470,1159919,551
7471681,168.117,226.449,579,30105,0.541571,0,2,1160698,1160119,579
7474601,172.603,223.143,583,29170,0.547625,0,2,1160902,1160319,583
7477521,182.527,220.25,635,28382,0.567922,0,2,1161154,1160519,635
7480441,192.711,217.719,699,27856,0.588181,0,2,1161418,1160719,699
7483361,194.123,215.504,703,27652,0.615909,0,2,1161622,1160919,703
7486281,201.357,213.566,755,27477,0.65267,0,2,1161874,1161119,755
7489201,203.188,211.87,771,27477,0.694836,0,2,1162090,1161319,771
7540301,207.306,344.15,2426,5840,0.976053,0,2,1172400,1169974,2426
7587021,193.956,49.8781,3766,11680,0.986231,0,2,1177344,1173578,3766
7587021,218.404,8.79052,6646,5840,0.983823,0,2,1180224,1173578,6646
7632281,210.682,534.598,1148,13140,0.992398,0,2,1181612,1180464,1148
7633741,209.847,487.273,1196,14600,0.982098,0,2,1181816,1180620,1196
7633741,187.116,426.364,1224,16060,0.970586,0,2,1181844,1180620,1224
7636661,179.671,137.052,2292,5840,0.977281,0,2,1184532,1182240,2292
7636661,184.212,119.92,2508,5840,0.942621,0,2,1184748,1182240,2508
7636661,186.686,104.93,2712,5840,0.911043,0,2,1184952,1182240,2712
7636661,187.35,91.814,2904,1460,0.903413,0,2,1185144,1182240,2904
7670241,213.003,157.542,2010,8760,0.965546,0,2,1187976,1185966,2010
7670241,215.247,61.8662,3510,8760,0.98522,0,2,1189476,1185966,3510
7670241,208.688,27.7653,4734,13140,0.987117,0,2,1190700,1185966,4734
7670241,211.102,24.2946,4962,14600,0.983727,0,2,1190928,1185966,4962
7670241,226.084,10.9033,6426,1460,0.982697,0,2,1192392,1185966,6426
7708201,275.268,652.362,1111,10220,0.986107,0,2,1193732,1192621,1111
7711121,251.954,126.356,3777,18980,0.982552,0,2,1196820,1193043,3777
7711121,248.96,110.562,4005,17232,0.982233,0,2,1197048,1193043,4005
7711121,219.843,19.4854,6801,7300,0.985619,0,2,1199844,1193043,6801
7737401,193.19,123.201,3553,11680,0.994552,0,2,1202868,1199315,3553
7737401,197.541,107.801,3781,13140,0.993983,0,2,1203096,1199315,3781
7737401,201.375,16.624,6589,7300,0.996572,0,2,1205904,1199315,6589
7794341,212.625,475.478,1209,17520,0.997404,0,2,1207452,1206243,1209
7794341,214.723,318.533,1869,11680,0.997011,0,2,1208112,1206243,1869
7816241,188.32,147.818,2246,11680,0.99848,0,2,1211586,1209340,2246
7817701,195.445,293.495,1106,5840,0.997732,0,2,1212224,1211118,1106
7849821,208.387,297.659,1264,13140,0.993571,0,2,1216018,1214754,1264
7849821,213.838,260.452,1516,14600,0.993124,0,2,1216270,1214754,1516
7849821,195.155,174.482,2001,5840,0.994144,0,2,1216755,1214754,2001
7854201,321.947,462.088,770,1460,0.983016,0,2,1218152,1217382,770
7880741,445.355,330.62,2413,11680,0.980208,0,2,1229029,1226616,2413
7895341,246.144,124.621,3322,7300,0.996705,0,2,1232689,1229367,3322
7895341,264.061,14.7136,7599,13140,0.987111,0,2,1236966,1229367,7599
7895341,261.781,11.2651,8108,5840,0.988882,0,2,1237475,1229367,8108
7895341,278.559,9.85699,8504,5840,0.956522,0,2,1237871,1229367,8504
7942061,636.275,1066.27,1282,16376,0.968264,0,2,1243252,1241970,1282
7942061,466.272,546.899,2710,1460,0.981222,0,2,1244680,1241970,2710
7942061,443.988,478.537,2998,5840,0.981069,0,2,1244968,1241970,2998
7966881,290.829,253.885,2164,10220,0.982765,0,2,1249169,1247005,2164
7966881,287.475,222.149,2428,11680,0.972419,0,2,1249433,1247005,2428
7975641,275.43,273.07,1596,10220,0.978354,0,2,1250741,1249145,1596
7975641,269.502,238.936,1824,5840,0.967309,0,2,1250969,1249145,1824
7975641,262.814,209.069,2040,7300,0.970146,0,2,1251185,1249145,2040
7987321,242.717,335.943,808,8760,0.965893,0,2,1251549,1250741,808
7994621,264.508,292.882,1056,11680,0.976256,0,2,1253009,1251953,1056
8004841,266.77,275.058,1098,20688,0.986844,0,2,1254605,1253507,1098
8016521,246.858,136.261,2162,4380,0.994472,0,2,1257225,1255063,2162
8025281,244.5,311.478,852,23616,0.990163,0,2,1257453,1256601,852
8038421,239.292,74.1593,3306,8760,0.995234,0,2,1261845,1258539,3306
8063241,215.845,572.303,1285,13140,0.986857,0,2,1264965,1263680,1285
8063241,234.732,224.741,3041,7300,0.991089,0,2,1266721,1263680,3041
8063241,242.431,100.863,4533,5840,0.984751,0,2,1268213,1263680,4533
8093901,405.738,600.805,1136,23360,0.989811,0,2,1271017,1269881,1136
8095361,383.77,548.954,1180,24820,0.981085,0,2,1271247,1270067,1180
8099741,246.315,378.786,960,11680,0.985563,0,2,1272859,1271899,960
8099741,220.392,148.748,2388,18980,0.993081,0,2,1274287,1271899,2388
8127481,199.938,272.712,1323,13140,0.988872,0,2,1275838,1274515,1323
8127481,197.446,238.623,1503,13140,0.985263,0,2,1276018,1274515,1503
8158141,219.318,166.531,2261,16060,0.994402,0,2,1281766,1279505,2261
8158141,220.403,145.714,2489,1460,0.991352,0,2,1281994,1279505,2489
8181501,212.147,57.4937,3516,10220,0.998151,0,2,1285954,1282438,3516
8181501,235.138,22.5775,5232,17520,0.995524,0,2,1287670,1282438,5232
8212161,211.207,543.695,1264,14600,0.987212,0,2,1289278,1288014,1264
8229681,180.866,213.375,1752,16060,0.984929,0,2,1292218,1290466,1752
8229681,188.837,83.7915,3072,8760,0.986582,0,2,1293538,1290466,3072
8229681,180.661,28.7915,4452,16060,0.994139,0,2,1294918,1290466,4452
8229681,193.906,11.3063,5880,10220,0.996449,0,2,1296346,1290466,5880
8229681,189.834,3.88495,7320,17520,0.99628,0,2,1297786,1290466,7320
8229681,194.855,3.39933,7550,18980,0.992995,0,2,1298016,1290466,7550
8229681,237.035,0.782496,10418,18551,0.989637,0,2,1300884,1290466,10418
8229681,235.906,0.684684,10646,18551,0.984683,0,2,1301112,1290466,10646
8301221,235.547,1174.99,1310,11680,0.970626,0,2,1302516,1301206,1310
8301221,233.104,1028.12,1526,11680,0.954297,0,2,1302732,1301206,1526
8318741,250.015,448.112,1030,19407,0.98573,0,2,1305716,1304686,1030
8328961,236.855,304.984,1110,19976,0.991896,0,2,1307312,1306202,1110
8330421,223.433,130.761,2358,8760,0.994318,0,2,1308756,1306398,2358
8353781,224.809,56.0323,3647,11680,0.991019,0,2,1314248,1310601,3647
8353781,225.208,49.0283,3875,11680,0.987142,0,2,1314476,1310601,3875
8353781,224.057,42.8997,4091,11680,0.987499,0,2,1314692,1310601,4091
8353781,223.05,37.5373,4307,11680,0.985312,0,2,1314908,1310601,4307
8353781,226.648,28.7395,4787,14600,0.987504,0,2,1315388,1310601,4787
8385901,216.481,473.311,1029,5840,0.987963,0,2,1317512,1316483,1029
8388821,235.921,454.523,1078,20440,0.980717,0,2,1317884,1316806,1078
8401961,206.421,61.7963,3692,13140,0.994725,0,2,1322324,1318632,3692
8401961,224.697,2.86515,8768,26280,0.996005,0,2,1327400,1318632,8768
8515841,200.216,132.089,2919,7300,0.997497,0,2,1337840,1334921,2919
8515841,200.896,45.3868,4515,13140,0.99789,0,2,1339436,1334921,4515
8521681,234.088,659.279,867,10220,0.995168,0,2,1340876,1340009,867
8521681,219.661,295.881,2115,16060,0.995331,0,2,1342124,1340009,2115
8521681,220.703,258.896,2343,1460,0.987165,0,2,1342352,1340009,2343
8565481,202.884,134.175,2285,17520,0.994735,0,2,1345376,1343091,2285
8584461,182.38,368.966,1180,14600,0.993417,0,2,1346900,1345720,1180
8587381,172.163,137.411,2208,24820,0.996771,0,2,1348400,1346192,2208
8587381,168.002,47.2158,3540,11680,0.99389,0,2,1349732,1346192,3540
8587381,198.028,18.5414,5052,21900,0.990101,0,2,1351244,1346192,5052
8587381,214.249,7.28115,6612,10220,0.981113,0,2,1352804,1346192,6612
8587381,214.843,6.371,6831,11680,0.978473,0,2,1353023,1346192,6831
8587381,217.964,2.85928,8139,5840,0.982839,0,2,1354331,1346192,8139
8588841,635.941,1423.92,760,26280,0.969754,0,2,1358328,1357568,760
8599061,566.948,1258.43,744,27740,0.941034,0,2,1358412,1357668,744
8601981,511.08,1113.62,764,29200,0.917155,0,2,1358532,1357768,764
8648701,456.195,986.92,736,30660,0.896261,0,2,1358604,1357868,736
8651621,426.795,876.055,857,32120,0.867978,0,2,1358825,1357968,857
8651761,406.071,791.548,918,35040,0.830731,0,2,1359086,1358168,918
8654681,539.319,570.915,2260,16060,0.923529,0,2,1365064,1362804,2260
8654681,498.904,499.55,2476,1460,0.915588,0,2,1365280,1362804,2476
8672201,338.391,473.732,843,11680,0.964352,0,2,1366948,1366105,843
8688261,262.3,280.716,1110,18390,0.983044,0,2,1369668,1368558,1110
8689721,256.512,273.502,1103,18390,0.963914,0,2,1369884,1368781,1103
8704321,242.324,232.891,1448,10220,0.982732,0,2,1372684,1371236,1448
8705781,264.033,299.405,1099,10220,0.96614,0,2,1373100,1372001,1099
8705781,233.029,261.979,1115,11680,0.950373,0,2,1373116,1372001,1115
8705781,245.901,229.232,1451,13140,0.935326,0,2,1373452,1372001,1451
8705781,239.163,200.578,1643,14600,0.92216,0,2,1373644,1372001,1643
8705781,228.768,175.505,1799,7300,0.90314,0,2,1373800,1372001,1799
8705781,215.172,153.567,1919,7300,0.888998,0,2,1373920,1372001,1919
8705781,210.775,134.371,2099,8760,0.876623,0,2,1374100,1372001,2099
8705781,209.928,117.575,2303,10220,0.860795,0,2,1374304,1372001,2303
8717461,192.687,308.253,732,1460,0.846946,0,2,1374376,1373644,732
8718921,210.101,290.471,898,5840,0.839827,0,2,1374708,1373810,898
8720381,215.339,285.663,898,7300,0.838599,0,2,1374960,1374062,898
8721841,194.921,283.455,682,8760,0.840024,0,2,1375012,1374330,682
8721841,197.556,248.023,898,10220,0.846271,0,2,1375228,1374330,898
8739361,223.389,213.146,1226,5840,0.964157,0,2,1378404,1377178,1226
8739361,197.465,186.503,1242,5840,0.963637,0,2,1378420,1377178,1242
8756881,264.487,270.212,1175,13140,0.98663,0,2,1381536,1380361,1175
8758341,213.717,40.1811,3806,11680,0.986946,0,2,1384360,1380554,3806
8758341,207.696,12.0808,5702,1460,0.984825,0,2,1386256,1380554,5702
8758341,208.734,10.5707,5918,5840,0.966722,0,2,1386472,1380554,5918
8758341,209.642,9.24933,6134,7300,0.939632,0,2,1386688,1380554,6134
8758341,193.937,8.09317,6218,8760,0.915928,0,2,1386772,1380554,6218
8758341,183.195,7.08152,6326,10220,0.892687,0,2,1386880,1380554,6326
8758341,176.796,6.19633,6458,11680,0.864851,0,2,1387012,1380554,6458
8772941,159.196,708.672,868,13140,0.845495,0,2,1387048,1386180,868
8793381,149.797,638.588,804,14600,0.833558,0,2,1387132,1386328,804
8802141,144.572,577.264,764,16060,0.820613,0,2,1387240,1386476,764
8802141,140,505.106,872,17520,0.811786,0,2,1387348,1386476,872
8802141,136,441.968,980,17520,0.806563,0,2,1387456,1386476,980
8802141,134,386.722,1100,17520,0.794493,0,2,1387576,1386476,1100
8805061,154.75,412.382,808,17520,0.801431,0,2,1387876,1387068,808
8807981,159.407,392.834,744,20440,0.810002,0,2,1388068,1387324,744
8810901,158.981,363.98,738,23360,0.822502,0,2,1388224,1387486,738
8826961,204.367,99.2137,2526,20440,0.958718,0,2,1390984,1388458,2526
8826961,207.321,86.812,2754,1460,0.962628,0,2,1391212,1388458,2754
8840101,172.701,101.786,2586,1460,0.983088,0,2,1393816,1391230,2586
8867841,175.948,76.2701,2640,1460,0.990971,0,2,1396972,1394332,2640
8867841,182.455,66.7364,2868,5840,0.9896,0,2,1397200,1394332,2868
8898501,154.377,198.05,1200,21900,0.994155,0,2,1398760,1397560,1200
8898501,161.369,101.582,2076,5840,0.989502,0,2,1399636,1397560,2076
8898501,169.698,88.8841,2304,5840,0.955814,0,2,1399864,1397560,2304
8898501,173.986,77.7736,2508,30660,0.922588,0,2,1400068,1397560,2508
8898501,165.737,68.0519,2616,32120,0.883514,0,2,1400176,1397560,2616
8898501,163.02,59.5454,2760,33580,0.846825,0,2,1400320,1397560,2760
8904341,190.643,364.227,647,35040,0.809722,0,2,1400704,1400057,647
8905801,174.312,327.699,635,36500,0.779757,0,2,1400764,1400129,635
8907261,158.523,295.736,611,37960,0.756037,0,2,1400812,1400201,611
8908721,147.708,267.769,611,39420,0.740282,0,2,1400884,1400273,611
8911641,133.744,243.298,575,40880,0.723997,0,2,1400920,1400345,575
8913101,124.526,221.886,563,42340,0.709747,0,2,1400980,1400417,563
8914561,120.961,203.15,587,43800,0.702279,0,2,1401076,1400489,587
8916021,110.341,186.756,551,44476,0.698244,0,2,1401112,1400561,551
8917481,110.048,172.412,587,44476,0.697214,0,2,1401220,1400633,587
8930621,102.292,159.86,563,44476,0.701312,0,2,1401268,1400705,563
8933541,110.505,148.878,659,44476,0.707398,0,2,1401436,1400777,659
8936461,116.192,148.268,671,42000,0.720223,0,2,1401592,1400921,671
8939381,122.668,147.735,695,40788,0.738945,0,2,1401760,1401065,695
8942301,131.335,147.268,743,39849,0.767827,0,2,1401952,1401209,743
8962741,198.265,15.2103,4119,14600,0.978081,0,2,1406356,1402237,4119
8962741,201.982,13.309,4347,16060,0.960821,0,2,1406584,1402237,4347
8962741,203.734,11.6454,4563,17520,0.964468,0,2,1406800,1402237,4563
9010921,188.075,70.0835,3240,5840,0.993255,0,2,1412872,1409632,3240
9010921,187.066,61.323,3420,5840,0.975348,0,2,1413052,1409632,3420
9010921,177.182,53.6577,3528,5840,0.955929,0,2,1413160,1409632,3528
9010921,177.535,46.9505,3708,5840,0.927688,0,2,1413340,1409632,3708
9015301,344.343,629.457,513,23360,0.882977,0,2,1414852,1414339,513
9037201,319.3,566.65,530,24820,0.851355,0,2,1414996,1414466,530
9040121,316.887,511.693,703,25475,0.838686,0,2,1415296,1414593,703
9043041,313.277,479.482,737,24993,0.8476,0,2,1415584,1414847,737
9054721,207.648,106.366,2534,13140,0.958998,0,2,1418524,1415990,2534
9054721,210.192,93.07,2762,1460,0.951624,0,2,1418752,1415990,2762
9111661,208.856,289.94,1032,11680,0.987048,0,2,1425724,1424692,1032
9111661,218.749,253.698,1320,13140,0.987417,0,2,1426012,1424692,1320
9111661,233.855,194.237,1872,5840,0.975366,0,2,1426564,1424692,1872
9111661,219.623,169.958,1992,5840,0.953445,0,2,1426684,1424692,1992
9113121,332.67,475.213,504,17520,0.900515,0,2,1427808,1427304,504
9114581,301.586,426.311,504,18980,0.8617,0,2,1427892,1427388,504
9116041,277.388,383.522,528,20440,0.832738,0,2,1428000,1427472,528
9118961,253.214,346.082,528,21900,0.817396,0,2,1428084,1427556,528
9132101,232.063,313.322,528,23360,0.803971,0,2,1428168,1427640,528
9135021,227.055,284.657,636,24820,0.802225,0,2,1428360,1427724,636
9137941,228.673,270.074,708,27740,0.820697,0,2,1428600,1427892,708
9140861,224.089,257.315,732,30660,0.84186,0,2,1428792,1428060,732
9158381,176.287,250.592,946,9820,0.962579,0,2,1431658,1430712,946
9158381,179.751,219.268,1150,9820,0.944756,0,2,1431862,1430712,1150
9158381,182.783,191.86,1354,9820,0.935412,0,2,1432066,1430712,1354
9158381,181.685,167.877,1528,9820,0.929735,0,2,1432240,1430712,1528
9161301,326.974,426.143,638,1460,0.884769,0,2,1433584,1432946,638
9176961,358.102,452.625,576,5840,0.865422,0,2,1434160,1433584,576
9179881,365.84,428.047,740,7300,0.878495,0,2,1434580,1433840,740
9188641,248.998,120.681,2618,13140,0.974277,0,2,1437424,1434806,2618
9193021,206.755,276.283,1440,14600,0.991016,0,2,1439092,1437652,1440
9193021,186.625,161.952,2100,5840,0.993484,0,2,1439752,1437652,2100
9193021,187.297,141.708,2292,5840,0.993048,0,2,1439944,1437652,2292
9228061,238.806,127.755,2524,16060,0.99735,0,2,1443328,1440804,2524
9239741,282.035,401.2,900,7300,0.992197,0,2,1444660,1443760,900
9239741,223.009,157.55,2232,17520,0.986936,0,2,1445992,1443760,2232
9239741,220.633,137.856,2436,18980,0.982319,0,2,1446196,1443760,2436
9239741,215.554,120.624,2616,1460,0.982029,0,2,1446376,1443760,2616
9264561,172.733,323.635,992,13140,0.990685,0,2,1447216,1446224,992
9302521,337.596,472.316,1121,26118,0.995961,0,2,1454172,1453051,1121
9303981,322.396,430.402,1200,26118,0.988966,0,2,1454388,1453188,1200
9303981,284.097,376.601,1216,26118,0.981595,0,2,1454404,1453188,1216
9306901,203.685,131.123,2424,18980,0.983767,0,2,1457248,1454824,2424
9306901,205.224,114.732,2640,1460,0.977046,0,2,1457464,1454824,2640
9356541,233.631,166.855,1918,7300,0.98861,0,2,1462000,1460082,1918
9356541,232.927,145.998,2146,7300,0.985034,0,2,1462228,1460082,2146
9365301,226.274,165.685,2004,5840,0.992873,0,2,1463776,1461772,2004
9376981,273.03,195.28,2199,7300,0.989107,0,2,1466536,1464337,2199
9385741,255.381,83.5332,3684,10220,0.99683,0,2,1469728,1466044,3684
9385741,261.017,42.8449,5004,14600,0.997124,0,2,1471048,1466044,5004
9385741,256.89,37.4893,5232,16060,0.996234,0,2,1471276,1466044,5232
9385741,253.278,32.8032,5460,1460,0.990454,0,2,1471504,1466044,5460
9417861,302.264,465.945,1112,14600,0.99047,0,2,1474116,1473004,1112
9425161,303.158,378.782,1141,15499,0.983862,0,2,1475580,1474439,1141
9426621,293.763,367.309,1082,16959,0.968379,0,2,1475808,1474726,1082
9435381,279.378,303.898,1130,18378,0.982059,0,2,1477404,1476274,1130
9457281,280.01,295.766,1123,16001,0.993147,0,2,1481700,1480577,1123
9473341,276.537,278.241,1084,16001,0.978422,0,2,1484664,1483580,1084
9474801,268.97,277.586,1027,16001,0.97612,0,2,1484880,1483853,1027
9479181,273.587,276.072,1036,15852,0.982752,0,2,1485708,1484672,1036
9482101,271.403,275.352,1020,18772,0.985545,0,2,1486238,1485218,1020
9483561,271.978,275.058,1023,18772,0.986101,0,2,1486514,1485491,1023
9498161,235.511,235.078,1044,19376,0.995094,0,2,1488770,1487726,1044
9499621,233.072,233.193,1040,19376,0.986957,0,2,1488986,1487946,1040
9501081,232.438,231.544,1048,19488,0.982337,0,2,1489214,1488166,1048
9521521,272.815,266.775,1091,25084,0.98969,0,2,1491806,1490715,1091
9522981,264.213,251.428,1151,25084,0.982228,0,2,1492010,1490859,1151
9522981,233.186,220,1167,25084,0.9732,0,2,1492026,1490859,1167
9544881,164.877,196.328,1583,14600,0.987577,0,2,1494850,1493267,1583
9546341,191.642,274.162,1143,14600,0.97663,0,2,1495229,1494086,1143
9546341,185.312,239.891,1284,17520,0.970801,0,2,1495370,1494086,1284
9546341,180.148,209.905,1428,1460,0.963201,0,2,1495514,1494086,1428
9546341,172.629,183.667,1548,5840,0.956551,0,2,1495634,1494086,1548
9546341,170.551,160.709,1704,7300,0.948232,0,2,1495790,1494086,1704
9546341,165.732,140.62,1836,8760,0.933453,0,2,1495922,1494086,1836
9546341,161.515,123.042,1968,10220,0.914272,0,2,1496054,1494086,1968
9546341,156.326,107.662,2088,11680,0.902488,0,2,1496174,1494086,2088
9559481,144.285,262.829,799,13140,0.882177,0,2,1496234,1495435,799
9559481,142.75,229.976,931,14600,0.866905,0,2,1496366,1495435,931
9559481,138.406,201.229,1039,14600,0.846042,0,2,1496474,1495435,1039
9559481,137.605,176.075,1171,14600,0.821536,0,2,1496606,1495435,1171
9559481,135.654,154.066,1293,14600,0.805094,0,2,1496728,1495435,1293
9559481,135.198,134.808,1425,14600,0.790707,0,2,1496860,1495435,1425
9562401,143.798,225.957,765,14600,0.778119,0,2,1497064,1496299,765
9565321,157.323,229.212,765,5840,0.773354,0,2,1497316,1496551,765
9566961,167.158,232.061,749,5840,0.770435,0,2,1497552,1496803,749
9574261,325.701,344.783,980,24820,0.844959,0,2,1499540,1498560,980
9575721,224.714,124.655,2154,14600,0.925477,0,2,1500840,1498686,2154
9575721,223.625,109.073,2370,16060,0.923542,0,2,1501056,1498686,2370
9623901,196.855,128.469,2067,11680,0.997684,0,2,1506516,1504449,2067
9623901,202.248,112.411,2307,11680,0.979224,0,2,1506756,1504449,2307
9638501,220.498,366.746,876,10220,0.986926,0,2,1508196,1507320,876
9638501,219.935,320.903,1092,11680,0.98606,0,2,1508412,1507320,1092
9638501,190.688,164.594,1908,5840,0.98035,0,2,1509228,1507320,1908
9638501,177.352,144.02,1992,5840,0.960306,0,2,1509312,1507320,1992
9638501,180.683,126.017,2196,5840,0.890268,0,2,1509516,1507320,2196
9638501,185.097,110.265,2412,21900,0.822735,0,2,1509732,1507320,2412
9638501,184.46,96.482,2592,23360,0.761143,0,2,1509912,1507320,2592
9641421,194.403,384.672,454,24820,0.69975,0,1,1510176,1509722,454
9658941,180.602,353.088,406,26280,0.638531,0,1,1510260,1509854,406
9661861,183.527,322.077,505,27740,0.594965,0,1,1510464,1509959,505
9664781,184.586,308.067,487,29022,0.554344,0,1,1510656,1510169,487
9667701,188.513,295.809,493,27783,0.531301,0,2,1510872,1510379,493
9670621,197.949,285.083,547,26722,0.518638,0,2,1511136,1510589,547
9673541,197.205,275.697,529,23369,0.512559,0,2,1511328,1510799,529
9676461,207.055,267.485,595,22739,0.527239,0,2,1511604,1511009,595
9679381,212.673,260.3,637,25659,0.565084,0,2,1511856,1511219,637
9682301,226.589,258.262,717,27504,0.608198,0,2,1512180,1511463,717
9752381,202.45,319.497,1176,5840,0.993419,0,2,1522440,1521264,1176
9752381,204.144,279.56,1392,5840,0.985492,0,2,1522656,1521264,1392
9752381,204.126,244.615,1596,5840,0.958555,0,2,1522860,1521264,1596
9752381,195.11,214.038,1728,5840,0.934986,0,2,1522992,1521264,1728
9761141,352.221,505.659,633,24558,0.906863,0,2,1524444,1523811,633
9766981,326.194,460.326,634,22450,0.877255,0,2,1524588,1523954,634
9771361,298.919,420.66,599,22450,0.856348,0,2,1524696,1524097,599
9777201,279.554,385.953,600,22450,0.843055,0,2,1524840,1524240,600
9780121,282.11,355.584,757,22450,0.836423,0,2,1525140,1524383,757
9783041,288.846,346.886,807,22246,0.83312,0,2,1525476,1524669,807
9785961,291.741,339.275,833,22184,0.83023,0,2,1525788,1524955,833
9788881,294.273,332.616,859,22184,0.828951,0,2,1526100,1525241,859
9791801,291.989,326.789,849,17733,0.829082,0,2,1526376,1525527,849
9794721,289.99,321.69,839,17733,0.834197,0,2,1526652,1525813,839
9797641,297.241,317.229,901,20653,0.848672,0,2,1527000,1526099,901
9807861,299.44,288,1112,20653,0.919883,0,2,1528532,1527420,1112
9809321,233.49,121.624,2248,8760,0.957288,0,2,1529820,1527572,2248
9809321,234.304,106.421,2488,8760,0.953877,0,2,1530060,1527572,2488
9829761,225.841,372.885,1012,11680,0.980638,0,2,1531584,1530572,1012
9837061,218.326,124.538,2488,8760,0.9886,0,2,1534368,1531880,2488
9839981,215.353,126.044,2496,5840,0.986083,0,2,1536072,1533576,2496
9839981,216.933,110.288,2724,19535,0.982823,0,2,1536300,1533576,2724
9869181,261.983,324.219,1016,23185,0.98744,0,2,1537968,1536952,1016
9872101,269.735,325.691,1004,23151,0.98651,0,2,1538292,1537288,1004
9873561,283.518,326.98,1048,23081,0.986946,0,2,1538672,1537624,1048
9876481,260.579,307.108,980,24541,0.987328,0,2,1538772,1537792,980
9892541,227.474,103.156,2579,1460,0.995546,0,2,1542180,1539601,2579
9912981,202.477,299.688,977,13140,0.994501,0,2,1543488,1542511,977
9915901,213.213,309.1,1080,7300,0.99686,0,2,1545240,1544160,1080
9934881,205.403,293.243,996,1460,0.994576,0,2,1548240,1547244,996
9946561,194.196,269.903,895,11680,0.996316,0,2,1549380,1548485,895
9952401,195.422,252.54,968,13140,0.988026,0,2,1549584,1548616,968
9964081,200.263,286.886,828,5840,0.993386,0,2,1551204,1550376,828
9988901,207.345,303.962,976,13140,0.998227,0,2,1555392,1554416,976
9988901,209.926,265.967,1204,14600,0.993448,0,2,1555620,1554416,1204
9988901,217.297,119.365,2548,5840,0.98456,0,2,1556964,1554416,2548
10013721,200.604,115.069,2273,10220,0.986369,0,2,1559628,1557355,2273
10013721,205.528,100.686,2513,10220,0.966823,0,2,1559868,1557355,2513
10034161,190.087,307.177,838,13140,0.983221,0,2,1561236,1560398,838
10034161,188.826,268.78,1018,14600,0.977819,0,2,1561416,1560398,1018
10048761,188.853,120.203,1967,14600,0.989282,0,2,1564044,1562077,1967
10048761,192.246,105.177,2183,16060,0.973122,0,2,1564260,1562077,2183
10048761,195.216,92.0301,2399,17520,0.957732,0,2,1564476,1562077,2399
10060441,196.314,279.901,1008,18980,0.956765,0,2,1564680,1563672,1008
10082341,200.396,265.725,970,11680,0.992083,0,2,1567260,1566290,970
10111541,220.296,280.101,1291,14600,0.995702,0,2,1571964,1570673,1291
10111541,205.951,109.995,2671,5840,0.994562,0,2,1573344,1570673,2671
10127601,233.854,292.692,1098,21900,0.993461,0,2,1574624,1573526,1098
10129061,181.243,94.1849,2326,11680,0.990534,0,2,1575996,1573670,2326
10131981,182.588,277.162,960,13140,0.981717,0,2,1576188,1575228,960
10131981,188.264,242.517,1188,13140,0.975253,0,2,1576416,1575228,1188
10131981,188.731,212.202,1380,14600,0.974596,0,2,1576608,1575228,1380
10131981,186.14,185.677,1548,16060,0.976522,0,2,1576776,1575228,1548
10131981,182.372,162.467,1704,16060,0.975706,0,2,1576932,1575228,1704
10131981,173.191,124.389,1992,18980,0.98015,0,2,1577220,1575228,1992
10131981,169.542,108.84,2136,20440,0.981381,0,2,1577364,1575228,2136
10174321,222.196,264.46,1237,23360,0.987488,0,2,1580336,1579099,1237
10174321,199.422,231.403,1277,24820,0.985302,0,2,1580376,1579099,1277
10267761,207.752,310.517,972,8760,0.997499,0,2,1593516,1592544,972
10308641,198.177,304.639,1382,13140,0.994941,0,2,1599372,1597990,1382
10308641,223.952,136.721,2870,5840,0.982729,0,2,1600860,1597990,2870
10308641,224.458,119.631,3098,7300,0.982388,0,2,1601088,1597990,3098
10326161,254.864,357.651,1114,5840,0.988426,0,2,1602236,1601122,1114
10327621,251.506,338.444,1138,5840,0.984873,0,2,1602464,1601326,1138
10334921,255.924,298.977,1145,23616,0.989741,0,2,1603772,1602627,1145
10355361,231.662,360.227,1126,11680,0.989668,0,2,1606728,1605602,1126
10355361,227.439,161.668,2458,7300,0.984113,0,2,1608060,1605602,2458
10403541,278.454,297.63,1094,13140,0.994779,0,2,1615736,1614642,1094
10413761,269.738,280.587,1072,23360,0.994822,0,2,1617008,1615936,1072
10416681,207.854,113.558,2106,10220,0.990721,0,2,1618368,1616262,2106
10416681,208.873,99.3629,2322,11680,0.980631,0,2,1618584,1616262,2322
10426901,219.932,355.964,1070,10220,0.978815,0,2,1619772,1618702,1070
10426901,219.44,311.469,1286,11680,0.980213,0,2,1619988,1618702,1286
10483841,255.811,343.817,792,1460,0.992392,0,2,1628533,1627741,792
10485301,247.835,321.215,821,20440,0.990843,0,2,1628725,1627904,821
10495521,253.936,265.554,1191,24820,0.98964,0,2,1630213,1629022,1191
10529101,171.676,120.425,1914,20440,0.994915,0,2,1636261,1634347,1914
10529101,184.26,41.3791,3462,13140,0.997003,0,2,1637809,1634347,3462
10529101,248.857,21.2237,5058,1460,0.997213,0,2,1639405,1634347,5058
10578741,202.726,163.614,2456,1460,0.99457,0,2,1642213,1639757,2456
10599181,177.8,297.63,1027,5840,0.995634,0,2,1643521,1642494,1027
10599181,184.075,260.426,1255,5840,0.98743,0,2,1643749,1642494,1255
10599181,251.849,152.657,2635,5840,0.988882,0,2,1645129,1642494,2635
10631301,208.728,282.228,1001,11680,0.994327,0,2,1649401,1648400,1001
10631301,213.245,216.081,1457,13140,0.994406,0,2,1649857,1648400,1457
10631301,211.303,110.83,2482,1460,0.994631,0,2,1650882,1648400,2482
10666341,213.009,144.3,2186,10220,0.993465,0,2,1655276,1653090,2186
10699921,199.601,29.4067,4486,5840,0.987459,0,2,1662608,1658122,4486
10699921,203.151,25.7309,4714,5840,0.987777,0,2,1662836,1658122,4714
10727661,263.97,557.206,957,23360,0.983061,0,2,1664000,1663043,957
10727661,256.474,487.556,1161,24820,0.982679,0,2,1664204,1663043,1161
10764161,202.601,156.417,1854,17520,0.996039,0,2,1670048,1668194,1854
10774381,221.502,131.926,2665,5840,0.983052,0,2,1672985,1670320,2665
10806501,187.924,222.708,1092,17520,0.991154,0,2,1674521,1673429,1092
10806501,189.934,194.869,1296,18980,0.97476,0,2,1674725,1673429,1296
10806501,191.692,170.511,1500,20440,0.971665,0,2,1674929,1673429,1500
10806501,190.231,149.197,1680,21900,0.963957,0,2,1675109,1673429,1680
10806501,172.893,66.9588,2655,8760,0.982574,0,2,1676084,1673429,2655
10816721,176.246,186.908,1663,14600,0.986907,0,2,1677284,1675621,1663
10828401,181.216,278.17,962,14600,0.983544,0,2,1677500,1676538,962
10828401,185.564,243.398,1178,16060,0.981851,0,2,1677716,1676538,1178
10845921,189.41,73.4737,2760,8760,0.995288,0,2,1681712,1678952,2760
10845921,194.234,64.2895,2988,10220,0.993377,0,2,1681940,1678952,2988
10845921,206.413,11.3304,5664,10220,0.992583,0,2,1684616,1678952,5664
10845921,242.152,5.81146,7032,14600,0.991196,0,2,1685984,1678952,7032
10845921,240.383,5.08503,7260,16060,0.989796,0,2,1686212,1678952,7260
10845921,209.704,1.02421,9804,28491,0.995445,0,2,1688756,1678952,9804
10845921,210.491,0.896185,10020,1460,0.994764,0,2,1688972,1678952,10020
10845921,205.97,0.686142,10404,7300,0.992241,0,2,1689356,1678952,10404
10845921,199.724,0.600374,10560,8760,0.991961,0,2,1689512,1678952,10560
10845921,189.758,0.525327,10680,10220,0.984216,0,2,1689632,1678952,10680
10869281,170.538,1235.96,832,11680,0.984939,0,2,1689668,1688836,832
10872201,170.221,1098.46,864,13140,0.983072,0,2,1689836,1688972,864
10892641,162.443,977.657,840,14600,0.981438,0,2,1689944,1689104,840
10923301,193.704,165.755,2422,11680,0.985308,0,2,1693100,1690678,2422
10923301,197.991,145.036,2650,1460,0.973395,0,2,1693328,1690678,2650
10923301,200.242,126.906,2866,5840,0.97297,0,2,1693544,1690678,2866
10945201,193.134,112.132,2383,8760,0.987603,0,2,1696352,1693969,2383
10948121,197.492,307.491,936,8760,0.980402,0,2,1696580,1695644,936
10948121,217.918,138,2316,14600,0.987455,0,2,1697960,1695644,2316
10948121,219.178,120.75,2544,1460,0.982773,0,2,1698188,1695644,2544
10977321,206.024,137.256,2096,8760,0.985714,0,2,1700900,1698804,2096
10977321,208.771,120.099,2324,8760,0.97375,0,2,1701128,1698804,2324
10996301,208.429,342.994,953,11680,0.980719,0,2,1702376,1701423,953
10996301,209.376,300.119,1169,13140,0.976879,0,2,1702592,1701423,1169
11007981,220.133,136.782,2230,10220,0.987178,0,2,1705316,1703086,2230
11007981,221.117,119.685,2458,10220,0.986281,0,2,1705544,1703086,2458
11007981,212.888,61.3873,3490,10220,0.989213,0,2,1706576,1703086,3490
11007981,214.777,53.7139,3718,11680,0.980561,0,2,1706804,1703086,3718
11007981,214.93,46.9997,3934,13140,0.981741,0,2,1707020,1703086,3934
11007981,208.519,9.46654,6322,8760,0.993822,0,2,1709408,1703086,6322
11022581,301.737,1406.88,831,21029,0.998423,0,2,1715168,1714337,831
11057621,291.02,1255.77,849,19229,0.98987,0,2,1715384,1714535,849
11080981,253.793,357.612,2163,5840,0.993918,0,2,1718156,1715993,2163
11095581,230.449,326.717,1320,11680,0.987271,0,2,1719476,1718156,1320
11095581,230.143,285.878,1548,11680,0.983862,0,2,1719704,1718156,1548
11104341,265.301,321.88,1136,18980,0.979222,0,2,1721260,1720124,1136
11132081,221.965,135.924,2270,5840,0.994355,0,2,1727012,1724742,2270
11142301,243.082,165.764,2220,1460,0.989966,0,2,1728596,1726376,2220
11156901,245.923,281.086,1119,11680,0.99356,0,2,1730248,1729129,1119
11177341,214.084,132.347,2492,5840,0.99336,0,2,1734428,1731936,2492
11193401,211.065,119.05,2374,13140,0.987726,0,2,1737512,1735138,2374
11196321,213.181,304.919,996,1460,0.97801,0,2,1737740,1736744,996
11213841,195.642,251.356,973,13140,0.988865,0,2,1739024,1738051,973
11215301,216.567,45.4587,3633,11680,0.994533,0,2,1741988,1738355,3633
11266401,215.374,236.323,1552,16060,0.992386,0,2,1747916,1746364,1552
11266401,188.44,158.318,1960,20440,0.993649,0,2,1748324,1746364,1960
11291221,172.434,166.41,2020,21900,0.99675,0,2,1750688,1748668,2020
11291221,177.879,145.609,2236,23360,0.989656,0,2,1750904,1748668,2236
11302901,149.224,290.751,1000,16060,0.994779,0,2,1752236,1751236,1000
11302901,179.717,34.3282,3784,14600,0.979384,0,2,1755020,1751236,3784
11302901,185.753,30.0371,4012,16060,0.978211,0,2,1755248,1751236,4012
11302901,211.267,13.4805,5440,8760,0.983971,0,2,1756676,1751236,5440
11302901,215.049,2.37581,8152,24820,0.984675,0,2,1759388,1751236,8152
11302901,184.8,0.280505,10996,11680,0.979441,0,2,1762232,1751236,10996
11302901,190.2,0.245442,11224,13140,0.973261,0,2,1762460,1751236,11224
11302901,209.513,0.110153,12556,21900,0.971749,0,2,1763792,1751236,12556
11302901,211.824,0.096384,12784,23360,0.969031,0,2,1764020,1751236,12784
11302901,250.822,0.0494362,14152,25580,0.971616,0,2,1765388,1751236,14152
11302901,244.969,0.0432567,14356,25580,0.967664,0,2,1765592,1751236,14356
11302901,320.603,0.0289786,15784,25580,0.975837,0,2,1767020,1751236,15784
11302901,378.762,0.0130055,18268,28500,0.986656,0,2,1769504,1751236,18268
11365681,425.712,2547.51,775,1460,0.98476,0,2,1772391,1771616,775
11433761,402.258,1647.32,786,10220,0.971067,0,2,1773987,1773201,786
11445441,603.174,1011.42,1061,13205,0.967558,0,2,1781423,1780362,1061
11446901,553.277,929.494,909,13205,0.960363,0,2,1781627,1780718,909
11451281,501.715,740.196,1029,13155,0.972197,0,2,1782815,1781786,1029
11462961,379.638,461.541,1021,16550,0.989196,0,2,1785407,1784386,1021
11464421,366.683,438.848,1017,16550,0.983047,0,2,1785683,1784666,1017
11521361,251.486,268.966,1099,18868,0.996169,0,2,1795607,1794508,1099
11531581,251.78,256.561,1117,5840,0.988281,0,2,1797095,1795978,1117
11533041,247.307,250.741,1123,5840,0.975995,0,2,1797311,1796188,1123
11534501,244.894,271.273,936,5840,0.975246,0,2,1797539,1796603,936
